form='absolut'	lemma='absolut'	
form='absoluta'	lemma='absolut'	
form='akut'	lemma='akut'	
form='akuta'	lemma='akut'	
form='alerta'	lemma='alert'	
form='andra'	lemma='andra'	
form='Andra'	lemma='andra'	
form='annorlunda'	lemma='annorlunda'	
form='arrogant'	lemma='arrogant'	
form='bastant'	lemma='bastant'	
form='bekant'	lemma='bekant'	
form='bekanta'	lemma='bekant'	
form='betalt'	lemma='betala'	
form='bevänt'	lemma='bevänt'	
form='bjärta'	lemma='bjärt'	
form='Blotta'	lemma='blott'	
form='blotta'	lemma='blott'	
form='blöt'	lemma='blöt'	
form='bosatta'	lemma='bosatt'	
form='bra'	lemma='bra'	
form='Bra'	lemma='bra'	
form='brant'	lemma='brant'	
form='brunrosa'	lemma='brunrosa'	
form='bäst'	lemma='bra'	
form='bästa'	lemma='bra'	
form='Bästa'	lemma='bra'	
form='bäste'	lemma='bra'	
form='Bättre'	lemma='bra'	
form='bättre'	lemma='bra'	
form='båda'	lemma='båda'	
form='Båda'	lemma='båda'	
form='desamma'	lemma='desamma'	
form='desperat'	lemma='desperat'	
form='desperata'	lemma='desperat'	
form='diskret'	lemma='diskret'	
form='djävulsbesatta'	lemma='djävulsbesatt'	
form='elegant'	lemma='elegant'	
form='eleganta'	lemma='elegant'	
form='ena'	lemma='ena'	
form='enahanda'	lemma='enahanda'	
form='enda'	lemma='enda'	
form='Enda'	lemma='enda'	
form='ene'	lemma='ena'	
form='enstaka'	lemma='enstaka'	
form='extra'	lemma='extra'	
form='extravagant'	lemma='extravagant'	
form='fet'	lemma='fet'	
form='feta'	lemma='fet'	
form='fixa'	lemma='fixa'	
form='flera'	lemma='flera'	
form='Flera'	lemma='flera'	
form='fortsatta'	lemma='fortsatt'	
form='framtida'	lemma='framtida'	
form='fullsatt'	lemma='fullsatt'	
form='fyrbenta'	lemma='fyrbent'	
form='föga'	lemma='föga'	
form='förment'	lemma='förment'	
form='förra'	lemma='förra'	
form='Förra'	lemma='förra'	
form='första'	lemma='första'	
form='Första'	lemma='första'	
form='förtida'	lemma='förtida'	
form='Förtida'	lemma='förtida'	
form='gladlynt'	lemma='gladlynt'	
form='glädjevitt'	lemma='glädjevit'	
form='grisfet'	lemma='grisfet'	
form='gråvita'	lemma='gråvit'	
form='halte'	lemma='halt'	
form='het'	lemma='het'	
form='heta'	lemma='het'	
form='Hett'	lemma='het'	
form='hett'	lemma='het'	
form='icke-vita'	lemma='icke-vit'	
form='illa'	lemma='illa'	
form='implicita'	lemma='implicit'	
form='Independent'	lemma='independent'	
form='indifferent'	lemma='indifferent'	
form='indifferenta'	lemma='indifferent'	
form='indiskret'	lemma='indiskret'	
form='inkompetenta'	lemma='inkompetent'	
form='intelligent'	lemma='intelligent'	
form='intelligenta'	lemma='intelligent'	
form='Intermittent'	lemma='Intermittent'	
form='intressant'	lemma='intressant'	
form='Intressant'	lemma='intressant'	
form='intressanta'	lemma='intressant'	
form='intressantare'	lemma='intressant'	
form='irrelevanta'	lemma='irrelevant'	
form='jäkla'	lemma='jäkla'	
form='jättebra'	lemma='jättebra'	
form='jävla'	lemma='jävla'	
form='knäckt'	lemma='knäcka'	
form='kokhett'	lemma='kokhet'	
form='kompetent'	lemma='kompetent'	
form='kompetenta'	lemma='kompetent'	
form='komplett'	lemma='komplett'	
form='konkret'	lemma='konkret'	
form='konkreta'	lemma='konkret'	
form='Konkreta'	lemma='konkret'	
form='konsekvent'	lemma='konsekvent'	
form='konsekventa'	lemma='konsekvent'	
form='konstant'	lemma='konstant'	
form='konstanta'	lemma='konstant'	
form='korpsvart'	lemma='korpsvart'	
form='kort'	lemma='kort'	
form='korta'	lemma='kort'	
form='kortare'	lemma='kort'	
form='kortaste'	lemma='kort'	
form='kortsynt'	lemma='kortsynt'	
form='kortväxt'	lemma='kortväxt'	
form='krigströtta'	lemma='krigstrött'	
form='kvitt'	lemma='kvitt'	
form='laga'	lemma='laga'	
form='latenta'	lemma='latent'	
form='laxrosa'	lemma='laxrosa'	
form='lika'	lemma='lika'	
form='lila'	lemma='lila'	
form='lodrät'	lemma='lodrät'	
form='lyckade'	lemma='lyckas'	
form='lätt'	lemma='lätt'	
form='lätta'	lemma='lätt'	
form='Lätta'	lemma='lätt'	
form='lättare'	lemma='lätt'	
form='lättast'	lemma='lätt'	
form='långväga'	lemma='långväga'	
form='matta'	lemma='matt'	
form='medeltida'	lemma='medeltida'	
form='mellersta'	lemma='mellersta'	
form='mer'	lemma='mycket'	
form='Mer'	lemma='mycket'	
form='mera'	lemma='mycket'	
form='mera'	lemma='mera'	
form='militant'	lemma='militant'	
form='mjölkvitt'	lemma='mjölkvit'	
form='moderat'	lemma='moderat'	
form='moderata'	lemma='moderat'	
form='morgontrötta'	lemma='morgontrött'	
form='motsatta'	lemma='motsatt'	
form='mycket'	lemma='mycket'	
form='mätta'	lemma='mätt'	
form='många'	lemma='många'	
form='Många'	lemma='många'	
form='nedersta'	lemma='nedersta'	
form='noga'	lemma='noga'	
form='nordvästra'	lemma='nordvästra'	
form='nordöstra'	lemma='nordöstra'	
form='Norra'	lemma='norra'	
form='norra'	lemma='norra'	
form='nutida'	lemma='nutida'	
form='nära'	lemma='nära'	
form='närmare'	lemma='nära'	
form='närmast'	lemma='nära'	
form='närmaste'	lemma='nära'	
form='Närmaste'	lemma='nära'	
form='närsynt'	lemma='närsynt'	
form='nästa'	lemma='nästa'	
form='Nästa'	lemma='nästa'	
form='nött'	lemma='nött'	
form='obekant'	lemma='obekant'	
form='ointelligent'	lemma='ointelligent'	
form='ointressant'	lemma='ointressant'	
form='omaka'	lemma='omaka'	
form='orätt'	lemma='orätt'	
form='permanent'	lemma='permanent'	
form='permanenta'	lemma='permanent'	
form='permanente'	lemma='permanent'	
form='platt'	lemma='platt'	
form='platta'	lemma='platt'	
form='plattare'	lemma='platt'	
form='privat'	lemma='privat'	
form='privata'	lemma='privat'	
form='ringa'	lemma='ringa'	
form='rosa'	lemma='rosa'	
form='rät'	lemma='rät'	
form='räta'	lemma='rät'	
form='rätt'	lemma='rätt'	
form='rätta'	lemma='rätt'	
form='Sakta'	lemma='sakta'	
form='salt'	lemma='salt'	
form='samma'	lemma='samma'	
form='sammansatta'	lemma='sammansatt'	
form='samtida'	lemma='samtida'	
form='satte'	lemma='satt'	
form='separat'	lemma='separat'	
form='separata'	lemma='separat'	
form='sista'	lemma='sista'	
form='Sista'	lemma='sista'	
form='siste'	lemma='sista'	
form='slut'	lemma='slut'	
form='släta'	lemma='slät'	
form='slätnötta'	lemma='slätnött'	
form='smart'	lemma='smart'	
form='smarta'	lemma='smart'	
form='smartare'	lemma='smart'	
form='snökrönta'	lemma='snökrönt'	
form='snövit'	lemma='snövit'	
form='snövita'	lemma='snövit'	
form='Stilla'	lemma='stilla'	
form='stilla'	lemma='stilla'	
form='stolt'	lemma='stolt'	
form='stolte'	lemma='stolt'	
form='styvsint'	lemma='styvsint'	
form='svart'	lemma='svart'	
form='Svart'	lemma='svart'	
form='svarta'	lemma='svart'	
form='Svarta'	lemma='svart'	
form='svartas'	lemma='svart'	
form='svarte'	lemma='svart'	
form='sydvästra'	lemma='sydvästra'	
form='sydöstra'	lemma='sydöstra'	
form='sysselsatta'	lemma='sysselsatt'	
form='sällsynt'	lemma='sällsynt'	
form='sällsynta'	lemma='sällsynt'	
form='södra'	lemma='södra'	
form='Södra'	lemma='södra'	
form='söt'	lemma='söt'	
form='sött'	lemma='söt'	
form='toleranta'	lemma='tolerant'	
form='tolerantare'	lemma='tolerant'	
form='trebent'	lemma='trebent'	
form='trivsamma'	lemma='trivsamma'	
form='trött'	lemma='trött'	
form='trötta'	lemma='trött'	
form='tungsint'	lemma='tungsint'	
form='tät'	lemma='tät'	
form='täta'	lemma='tät'	
form='tätast'	lemma='tät'	
form='tätt'	lemma='tät'	
form='udda'	lemma='udda'	
form='uppblötta'	lemma='uppblött'	
form='upprätta'	lemma='upprätt'	
form='urarva'	lemma='urarva'	
form='utsatta'	lemma='utsatt'	
form='vattentäta'	lemma='vattentät'	
form='vidsynta'	lemma='vidsynt'	
form='vinkelräta'	lemma='vinkelrät'	
form='vit'	lemma='vit'	
form='Vit'	lemma='vit'	
form='vita'	lemma='vit'	
form='Vita'	lemma='vit'	
form='vitas'	lemma='vit'	
form='vitaste'	lemma='vit'	
form='vite'	lemma='vit'	
form='vitt'	lemma='vit'	
form='välbekant'	lemma='välbekant'	
form='välbekanta'	lemma='välbekant'	
form='välskött'	lemma='välskött'	
form='välskötta'	lemma='välskött'	
form='Västra'	lemma='västra'	
form='västra'	lemma='västra'	
form='vågrät'	lemma='vågrät'	
form='våta'	lemma='våt'	
form='vått'	lemma='våt'	
form='yra'	lemma='yra'	
form='äkta'	lemma='äkta'	
form='östra'	lemma='östra'	
form='översatta'	lemma='översatt'