form='dubbade'	lemma='dubba'	feats='Case=Nom|Definite=Ind|Degree=Pos|Number=Plur|Tense=Past|VerbForm=Part'	treebank='talbanken'
form='avtrubbade'	lemma='avtrubba'	feats='Case=Nom|Definite=Ind|Degree=Pos|Number=Plur|Tense=Past|VerbForm=Part'	treebank='talbanken'
form='skadad'	lemma='skada'	feats='Case=Nom|Definite=Ind|Degree=Pos|Gender=Com|Number=Sing|Tense=Past|VerbForm=Part'	treebank='talbanken'
form='skadade'	lemma='skada'	feats='Case=Nom|Definite=Ind|Degree=Pos|Number=Plur|Tense=Past|VerbForm=Part'	treebank='talbanken'
form='skadade'	lemma='skada'	feats='Case=Nom|Number=Plur|Tense=Past|VerbForm=Part'	treebank='lines_test'
form='Skyddad'	lemma='skydda'	feats='Case=Nom|Definite=Ind|Degree=Pos|Gender=Com|Number=Sing|Tense=Past|VerbForm=Part'	treebank='talbanken'
form='skyddade'	lemma='skydda'	feats='Case=Nom|Definite=Def|Degree=Pos|Tense=Past|VerbForm=Part'	treebank='talbanken'
form='beskyddad'	lemma='beskydda'	feats='Case=Nom|Definite=Ind|Degree=Pos|Gender=Com|Number=Sing|Tense=Past|VerbForm=Part'	treebank='talbanken'
form='överbeskyddade'	lemma='överbeskydda'	feats='Case=Nom|Definite=Ind|Degree=Pos|Number=Plur|Tense=Past|VerbForm=Part'	treebank='talbanken'
form='ledd'	lemma='leda'	feats='Case=Nom|Definite=Ind|Gender=Com|Number=Sing|Tense=Past|VerbForm=Part'	treebank='talbanken'
form='ledda'	lemma='leda'	feats='Case=Nom|Number=Plur|Tense=Past|VerbForm=Part'	treebank='talbanken'
form='inlett'	lemma='inleda'	feats='Case=Nom|Definite=Ind|Gender=Neut|Number=Sing|Tense=Past|VerbForm=Part'	treebank='talbanken'
form='fredad'	lemma='freda'	feats='Case=Nom|Definite=Ind|Degree=Pos|Gender=Com|Number=Sing|Tense=Past|VerbForm=Part'	treebank='talbanken'
form='snedvridna'	lemma='snedvrida'	feats='Case=Nom|Definite=Def|Number=Sing|Tense=Past|VerbForm=Part'	treebank='talbanken'
form='utbildad'	lemma='utbilda'	feats='Case=Nom|Definite=Ind|Degree=Pos|Gender=Com|Number=Sing|Tense=Past|VerbForm=Part'	treebank='talbanken'
form='sistnämnda'	lemma='sistnämnda'	feats='Case=Nom|Definite=Def|Number=Sing|Tense=Past|VerbForm=Part'	treebank='talbanken'
form='sistnämnda'	lemma='sistnämnda'	feats='Case=Nom|Number=Plur|Tense=Past|VerbForm=Part'	treebank='talbanken'
form='översänt'	lemma='översända'	feats='Case=Nom|Definite=Ind|Gender=Neut|Number=Sing|Tense=Past|VerbForm=Part'	treebank='talbanken'
form='avsänd'	lemma='avsända'	feats='Case=Nom|Definite=Ind|Gender=Com|Number=Sing|Tense=Past|VerbForm=Part'	treebank='talbanken'
form='omvända'	lemma='omvända'	feats='Case=Nom|Definite=Def|Number=Sing|Tense=Past|VerbForm=Part'	treebank='talbanken'
form='använda'	lemma='använda'	feats='Case=Nom|Number=Plur|Tense=Past|VerbForm=Part'	treebank='talbanken'
form='kringgärdad'	lemma='kringgärda'	feats='Case=Nom|Definite=Ind|Degree=Pos|Gender=Com|Number=Sing|Tense=Past|VerbForm=Part'	treebank='talbanken'
form='påbjuden'	lemma='påbjuda'	feats='Case=Nom|Definite=Ind|Gender=Com|Number=Sing|Tense=Past|VerbForm=Part'	treebank='talbanken'
form='dödade'	lemma='döda'	feats='Case=Nom|Definite=Ind|Degree=Pos|Number=Plur|Tense=Past|VerbForm=Part'	treebank='talbanken'
form='fött'	lemma='föda'	feats='Case=Nom|Definite=Ind|Gender=Neut|Number=Sing|Tense=Past|VerbForm=Part'	treebank='talbanken'
form='vidgat'	lemma='vidga'	feats='Case=Nom|Definite=Ind|Degree=Pos|Gender=Neut|Number=Sing|Tense=Past|VerbForm=Part'	treebank='talbanken'
form='vidgad'	lemma='vidga'	feats='Case=Nom|Definite=Ind|Degree=Pos|Gender=Com|Number=Sing|Tense=Past|VerbForm=Part'	treebank='talbanken'
form='utvidgad'	lemma='utvidga'	feats='Case=Nom|Definite=Ind|Degree=Pos|Gender=Com|Number=Sing|Tense=Past|VerbForm=Part'	treebank='talbanken'
form='byggt'	lemma='bygga'	feats='Case=Nom|Definite=Ind|Gender=Neut|Number=Sing|Tense=Past|VerbForm=Part'	treebank='talbanken'
form='byggd'	lemma='bygga'	feats='Case=Nom|Definite=Ind|Gender=Com|Number=Sing|Tense=Past|VerbForm=Part'	treebank='talbanken'
form='byggda'	lemma='bygga'	feats='Case=Nom|Number=Plur|Tense=Past|VerbForm=Part'	treebank='talbanken'
form='uppbyggt'	lemma='uppbygga'	feats='Case=Nom|Definite=Ind|Gender=Neut|Number=Sing|Tense=Past|VerbForm=Part'	treebank='talbanken'
form='framlagt'	lemma='framlägga'	feats='Case=Nom|Definite=Ind|Gender=Neut|Number=Sing|Tense=Past|VerbForm=Part'	treebank='talbanken'
form='sammanlagd'	lemma='sammanlägga'	feats='Case=Nom|Definite=Ind|Gender=Com|Number=Sing|Tense=Past|VerbForm=Part'	treebank='talbanken'
form='sammanlagda'	lemma='sammanlägga'	feats='Case=Nom|Definite=Def|Number=Sing|Tense=Past|VerbForm=Part'	treebank='talbanken'
form='förverkligad'	lemma='förverkliga'	feats='Case=Nom|Definite=Ind|Degree=Pos|Gender=Com|Number=Sing|Tense=Past|VerbForm=Part'	treebank='talbanken'
form='invigda'	lemma='inviga'	feats='Case=Nom|Number=Plur|Tense=Past|VerbForm=Part'	treebank='talbanken'
form='påtvingad'	lemma='påtvinga'	feats='Case=Nom|Definite=Ind|Degree=Pos|Gender=Com|Number=Sing|Tense=Past|VerbForm=Part'	treebank='talbanken'
form='förlängd'	lemma='förlänga'	feats='Case=Nom|Definite=Ind|Gender=Com|Number=Sing|Tense=Past|VerbForm=Part'	treebank='talbanken'
form='förlängda'	lemma='förlänga'	feats='Case=Nom|Definite=Def|Number=Sing|Tense=Past|VerbForm=Part'	treebank='talbanken'
form='Utestängda'	lemma='utestänga'	feats='Case=Nom|Number=Plur|Tense=Past|VerbForm=Part'	treebank='talbanken'
form='fångade'	lemma='fånga'	feats='Case=Nom|Definite=Ind|Degree=Pos|Number=Plur|Tense=Past|VerbForm=Part'	treebank='talbanken'
form='sammanfogat'	lemma='sammanfoga'	feats='Case=Nom|Definite=Ind|Degree=Pos|Gender=Neut|Number=Sing|Tense=Past|VerbForm=Part'	treebank='talbanken'
form='bärgade'	lemma='bärga'	feats='Case=Nom|Definite=Def|Degree=Pos|Tense=Past|VerbForm=Part'	treebank='talbanken'
form='utsugna'	lemma='utsuga'	feats='Case=Nom|Number=Plur|Tense=Past|VerbForm=Part'	treebank='talbanken'
form='ägt'	lemma='äga'	feats='Case=Nom|Definite=Ind|Gender=Neut|Number=Sing|Tense=Past|VerbForm=Part'	treebank='talbanken'
form='sagt'	lemma='säga'	feats='Case=Nom|Definite=Ind|Gender=Neut|Number=Sing|Tense=Past|VerbForm=Part'	treebank='talbanken'
form='övervägt'	lemma='överväga'	feats='Case=Nom|Definite=Ind|Gender=Neut|Number=Sing|Tense=Past|VerbForm=Part'	treebank='talbanken'
form='befriad'	lemma='befria'	feats='Case=Nom|Definite=Ind|Degree=Pos|Gender=Com|Number=Sing|Tense=Past|VerbForm=Part'	treebank='talbanken'
form='frånskilda'	lemma='frånskilja'	feats='Case=Nom|Number=Plur|Tense=Past|VerbForm=Part'	treebank='talbanken'
form='åtskilda'	lemma='åtskilja'	feats='Case=Nom|Number=Plur|Tense=Past|VerbForm=Part'	treebank='talbanken'
form='valt'	lemma='välja'	feats='Case=Nom|Definite=Ind|Gender=Neut|Number=Sing|Tense=Past|VerbForm=Part'	treebank='talbanken'
form='valda'	lemma='välja'	feats='Case=Nom|Number=Plur|Tense=Past|VerbForm=Part'	treebank='talbanken'
form='utvalda'	lemma='utvälja'	feats='Case=Nom|Number=Plur|Tense=Past|VerbForm=Part'	treebank='talbanken'
form='utvald'	lemma='utvälja'	feats='Case=Nom|Definite=Ind|Gender=Com|Number=Sing|Tense=Past|VerbForm=Part'	treebank='talbanken'
form='dold'	lemma='dölja'	feats='Case=Nom|Definite=Ind|Gender=Com|Number=Sing|Tense=Past|VerbForm=Part'	treebank='talbanken'
form='dolda'	lemma='dölja'	feats='Case=Nom|Definite=Def|Number=Sing|Tense=Past|VerbForm=Part'	treebank='lines_test'
form='dolda'	lemma='dölja'	feats='Case=Nom|Definite=Def|Number=Sing|Tense=Past|VerbForm=Part'	treebank='talbanken'
form='smorda'	lemma='smörja'	feats='Case=Nom|Number=Plur|Tense=Past|VerbForm=Part'	treebank='talbanken'
form='utnyttjade'	lemma='utnyttja'	feats='Case=Nom|Definite=Ind|Degree=Pos|Number=Plur|Tense=Past|VerbForm=Part'	treebank='talbanken'
form='höjda'	lemma='höja'	feats='Case=Nom|Number=Plur|Tense=Past|VerbForm=Part'	treebank='talbanken'
form='höjd'	lemma='höja'	feats='Case=Nom|Definite=Ind|Gender=Com|Number=Sing|Tense=Past|VerbForm=Part'	treebank='talbanken'
form='Höjt'	lemma='höja'	feats='Case=Nom|Definite=Ind|Gender=Neut|Number=Sing|Tense=Past|VerbForm=Part'	treebank='talbanken'
form='fördröjd'	lemma='fördröja'	feats='Case=Nom|Definite=Ind|Gender=Com|Number=Sing|Tense=Past|VerbForm=Part'	treebank='talbanken'
form='förorsakade'	lemma='förorsaka'	feats='Case=Nom|Definite=Def|Degree=Pos|Tense=Past|VerbForm=Part'	treebank='talbanken'
form='streckad'	lemma='strecka'	feats='Case=Nom|Definite=Ind|Degree=Pos|Gender=Com|Number=Sing|Tense=Past|VerbForm=Part'	treebank='talbanken'
form='streckade'	lemma='strecka'	feats='Case=Nom|Definite=Ind|Degree=Pos|Number=Plur|Tense=Past|VerbForm=Part'	treebank='talbanken'
form='Uttryckt'	lemma='uttrycka'	feats='Case=Nom|Definite=Ind|Gender=Neut|Number=Sing|Tense=Past|VerbForm=Part'	treebank='talbanken'
form='uttryckt'	lemma='uttrycka'	feats='Case=Nom|Definite=Ind|Gender=Neut|Number=Sing|Tense=Past|VerbForm=Part'	treebank='talbanken'
form='anrikat'	lemma='anrika'	feats='Case=Nom|Definite=Ind|Degree=Pos|Gender=Neut|Number=Sing|Tense=Past|VerbForm=Part'	treebank='talbanken'
form='befolkade'	lemma='befolka'	feats='Case=Nom|Definite=Ind|Degree=Pos|Number=Plur|Tense=Past|VerbForm=Part'	treebank='talbanken'
form='sänkt'	lemma='sänka'	feats='Case=Nom|Definite=Ind|Gender=Com|Number=Sing|Tense=Past|VerbForm=Part'	treebank='talbanken'
form='tänkt'	lemma='tänka'	feats='Case=Nom|Definite=Ind|Gender=Neut|Number=Sing|Tense=Past|VerbForm=Part'	treebank='talbanken'
form='avverkade'	lemma='avverka'	feats='Case=Nom|Definite=Def|Degree=Pos|Tense=Past|VerbForm=Part'	treebank='talbanken'
form='torkad'	lemma='torka'	feats='Case=Nom|Definite=Ind|Degree=Pos|Gender=Com|Number=Sing|Tense=Past|VerbForm=Part'	treebank='talbanken'
form='märkt'	lemma='märka'	feats='Case=Nom|Definite=Ind|Gender=Neut|Number=Sing|Tense=Past|VerbForm=Part'	treebank='talbanken'
form='märkta'	lemma='märka'	feats='Case=Nom|Number=Plur|Tense=Past|VerbForm=Part'	treebank='talbanken'
form='minskade'	lemma='minska'	feats='Case=Nom|Definite=Def|Degree=Pos|Tense=Past|VerbForm=Part'	treebank='talbanken'
form='minskat'	lemma='minska'	feats='Case=Nom|Definite=Ind|Degree=Pos|Gender=Neut|Number=Sing|Tense=Past|VerbForm=Part'	treebank='talbanken'
form='minskad'	lemma='minska'	feats='Case=Nom|Definite=Ind|Degree=Pos|Gender=Com|Number=Sing|Tense=Past|VerbForm=Part'	treebank='talbanken'
form='minskade'	lemma='minska'	feats='Case=Nom|Definite=Ind|Degree=Pos|Number=Plur|Tense=Past|VerbForm=Part'	treebank='talbanken'
form='önskade'	lemma='önska'	feats='Case=Nom|Definite=Ind|Degree=Pos|Number=Plur|Tense=Past|VerbForm=Part'	treebank='talbanken'
form='önskat'	lemma='önska'	feats='Case=Nom|Definite=Ind|Degree=Pos|Gender=Neut|Number=Sing|Tense=Past|VerbForm=Part'	treebank='talbanken'
form='förbrukade'	lemma='förbruka'	feats='Case=Nom|Definite=Ind|Degree=Pos|Number=Plur|Tense=Past|VerbForm=Part'	treebank='talbanken'
form='Ökad'	lemma='öka'	feats='Case=Nom|Definite=Ind|Degree=Pos|Gender=Com|Number=Sing|Tense=Past|VerbForm=Part'	treebank='talbanken'
form='ökad'	lemma='öka'	feats='Case=Nom|Definite=Ind|Gender=Com|Number=Sing|Tense=Past|VerbForm=Part'	treebank='lines_test'
form='ökad'	lemma='öka'	feats='Case=Nom|Definite=Ind|Degree=Pos|Gender=Com|Number=Sing|Tense=Past|VerbForm=Part'	treebank='talbanken'
form='ökat'	lemma='öka'	feats='Case=Nom|Definite=Ind|Degree=Pos|Gender=Neut|Number=Sing|Tense=Past|VerbForm=Part'	treebank='talbanken'
form='ökade'	lemma='öka'	feats='Case=Nom|Number=Plur|Tense=Past|VerbForm=Part'	treebank='lines_test'
form='ökade'	lemma='öka'	feats='Case=Nom|Definite=Ind|Degree=Pos|Number=Plur|Tense=Past|VerbForm=Part'	treebank='talbanken'
form='ökade'	lemma='öka'	feats='Case=Nom|Definite=Def|Degree=Pos|Tense=Past|VerbForm=Part'	treebank='talbanken'
form='undersökta'	lemma='undersöka'	feats='Case=Nom|Definite=Def|Number=Sing|Tense=Past|VerbForm=Part'	treebank='talbanken'
form='utökad'	lemma='utöka'	feats='Case=Nom|Definite=Ind|Degree=Pos|Gender=Com|Number=Sing|Tense=Past|VerbForm=Part'	treebank='talbanken'
form='skalad'	lemma='skala'	feats='Case=Nom|Definite=Ind|Degree=Pos|Gender=Com|Number=Sing|Tense=Past|VerbForm=Part'	treebank='talbanken'
form='talade'	lemma='tala'	feats='Case=Nom|Definite=Def|Degree=Pos|Tense=Past|VerbForm=Part'	treebank='talbanken'
form='vidtalade'	lemma='vidtala'	feats='Case=Nom|Definite=Ind|Degree=Pos|Number=Plur|Tense=Past|VerbForm=Part'	treebank='talbanken'
form='betalt'	lemma='betala'	feats='Case=Nom|Definite=Ind|Gender=Neut|Number=Sing|Tense=Past|VerbForm=Part'	treebank='talbanken'
form='betalda'	lemma='betala'	feats='Case=Nom|Number=Plur|Tense=Past|VerbForm=Part'	treebank='talbanken'
form='uttalade'	lemma='uttala'	feats='Case=Nom|Definite=Def|Degree=Pos|Tense=Past|VerbForm=Part'	treebank='talbanken'
form='fördubblad'	lemma='fördubbla'	feats='Case=Nom|Definite=Ind|Degree=Pos|Gender=Com|Number=Sing|Tense=Past|VerbForm=Part'	treebank='talbanken'
form='databehandlade'	lemma='databehandla'	feats='Case=Nom|Definite=Ind|Degree=Pos|Number=Plur|Tense=Past|VerbForm=Part'	treebank='talbanken'
form='odlade'	lemma='odla'	feats='Case=Nom|Definite=Def|Degree=Pos|Tense=Past|VerbForm=Part'	treebank='talbanken'
form='renodlad'	lemma='renodla'	feats='Case=Nom|Definite=Ind|Degree=Pos|Gender=Com|Number=Sing|Tense=Past|VerbForm=Part'	treebank='talbanken'
form='renodlade'	lemma='renodla'	feats='Case=Nom|Definite=Ind|Degree=Pos|Number=Plur|Tense=Past|VerbForm=Part'	treebank='talbanken'
form='renodlat'	lemma='renodla'	feats='Case=Nom|Definite=Ind|Degree=Pos|Gender=Neut|Number=Sing|Tense=Past|VerbForm=Part'	treebank='talbanken'
form='förädlade'	lemma='förädla'	feats='Case=Nom|Definite=Ind|Degree=Pos|Number=Plur|Tense=Past|VerbForm=Part'	treebank='talbanken'
form='indelade'	lemma='indela'	feats='Case=Nom|Definite=Ind|Degree=Pos|Number=Plur|Tense=Past|VerbForm=Part'	treebank='talbanken'
form='uppdelad'	lemma='uppdela'	feats='Case=Nom|Definite=Ind|Degree=Pos|Gender=Com|Number=Sing|Tense=Past|VerbForm=Part'	treebank='talbanken'
form='uppdelat'	lemma='uppdela'	feats='Case=Nom|Definite=Ind|Degree=Pos|Gender=Neut|Number=Sing|Tense=Past|VerbForm=Part'	treebank='talbanken'
form='fördelad'	lemma='fördela'	feats='Case=Nom|Definite=Ind|Degree=Pos|Gender=Com|Number=Sing|Tense=Past|VerbForm=Part'	treebank='talbanken'
form='fördelat'	lemma='fördela'	feats='Case=Nom|Definite=Ind|Degree=Pos|Gender=Neut|Number=Sing|Tense=Past|VerbForm=Part'	treebank='talbanken'
form='fördelade'	lemma='fördela'	feats='Case=Nom|Definite=Ind|Degree=Pos|Number=Plur|Tense=Past|VerbForm=Part'	treebank='talbanken'
form='beseglat'	lemma='besegla'	feats='Case=Nom|Definite=Ind|Degree=Pos|Gender=Neut|Number=Sing|Tense=Past|VerbForm=Part'	treebank='talbanken'
form='inpräglade'	lemma='inprägla'	feats='Case=Nom|Definite=Ind|Degree=Pos|Number=Plur|Tense=Past|VerbForm=Part'	treebank='talbanken'
form='förenklad'	lemma='förenkla'	feats='Case=Nom|Definite=Ind|Degree=Pos|Gender=Com|Number=Sing|Tense=Past|VerbForm=Part'	treebank='talbanken'
form='kallad'	lemma='kalla'	feats='Case=Nom|Definite=Ind|Degree=Pos|Gender=Com|Number=Sing|Tense=Past|VerbForm=Part'	treebank='talbanken'
form='framställda'	lemma='framställa'	feats='Case=Nom|Number=Plur|Tense=Past|VerbForm=Part'	treebank='talbanken'
form='framställd'	lemma='framställa'	feats='Case=Nom|Definite=Ind|Gender=Com|Number=Sing|Tense=Past|VerbForm=Part'	treebank='talbanken'
form='Framställt'	lemma='framställa'	feats='Case=Nom|Definite=Ind|Gender=Neut|Number=Sing|Tense=Past|VerbForm=Part'	treebank='talbanken'
form='säkerställda'	lemma='säkerställa'	feats='Case=Nom|Number=Plur|Tense=Past|VerbForm=Part'	treebank='talbanken'
form='återställda'	lemma='återställa'	feats='Case=Nom|Number=Plur|Tense=Past|VerbForm=Part'	treebank='talbanken'
form='fastställda'	lemma='fastställa'	feats='Case=Nom|Number=Plur|Tense=Past|VerbForm=Part'	treebank='talbanken'
form='fastställda'	lemma='fastställa'	feats='Case=Nom|Definite=Def|Number=Sing|Tense=Past|VerbForm=Part'	treebank='talbanken'
form='samlade'	lemma='samla'	feats='Case=Nom|Definite=Def|Degree=Pos|Tense=Past|VerbForm=Part'	treebank='talbanken'
form='avkopplat'	lemma='avkoppla'	feats='Case=Nom|Definite=Ind|Degree=Pos|Gender=Neut|Number=Sing|Tense=Past|VerbForm=Part'	treebank='talbanken'
form='anmälda'	lemma='anmäla'	feats='Case=Nom|Number=Plur|Tense=Past|VerbForm=Part'	treebank='talbanken'
form='anmäld'	lemma='anmäla'	feats='Case=Nom|Definite=Ind|Gender=Com|Number=Sing|Tense=Past|VerbForm=Part'	treebank='talbanken'
form='arbetsanmälda'	lemma='arbetsanmäla'	feats='Case=Nom|Number=Plur|Tense=Past|VerbForm=Part'	treebank='talbanken'
form='Målade'	lemma='måla'	feats='Case=Nom|Definite=Ind|Degree=Pos|Number=Plur|Tense=Past|VerbForm=Part'	treebank='talbanken'
form='stämd'	lemma='stämma'	feats='Case=Nom|Definite=Ind|Gender=Com|Number=Sing|Tense=Past|VerbForm=Part'	treebank='talbanken'
form='bestämt'	lemma='bestämma'	feats='Case=Nom|Definite=Ind|Gender=Neut|Number=Sing|Tense=Past|VerbForm=Part'	treebank='talbanken'
form='berömda'	lemma='berömma'	feats='Case=Nom|Definite=Def|Number=Sing|Tense=Past|VerbForm=Part'	treebank='talbanken'
form='berömda'	lemma='berömma'	feats='Case=Nom|Number=Plur|Tense=Past|VerbForm=Part'	treebank='talbanken'
form='formad'	lemma='forma'	feats='Case=Nom|Definite=Ind|Degree=Pos|Gender=Com|Number=Sing|Tense=Past|VerbForm=Part'	treebank='talbanken'
form='utformat'	lemma='utforma'	feats='Case=Nom|Definite=Ind|Degree=Pos|Gender=Neut|Number=Sing|Tense=Past|VerbForm=Part'	treebank='talbanken'
form='utformad'	lemma='utforma'	feats='Case=Nom|Definite=Ind|Degree=Pos|Gender=Com|Number=Sing|Tense=Past|VerbForm=Part'	treebank='talbanken'
form='utformade'	lemma='utforma'	feats='Case=Nom|Definite=Ind|Degree=Pos|Number=Plur|Tense=Past|VerbForm=Part'	treebank='talbanken'
form='dömda'	lemma='döma'	feats='Case=Nom|Number=Plur|Tense=Past|VerbForm=Part'	treebank='talbanken'
form='ordnat'	lemma='ordna'	feats='Case=Nom|Definite=Ind|Degree=Pos|Gender=Neut|Number=Sing|Tense=Past|VerbForm=Part'	treebank='talbanken'
form='ordnade'	lemma='ordna'	feats='Case=Nom|Definite=Ind|Degree=Pos|Number=Plur|Tense=Past|VerbForm=Part'	treebank='talbanken'
form='ordnad'	lemma='ordna'	feats='Case=Nom|Definite=Ind|Degree=Pos|Gender=Com|Number=Sing|Tense=Past|VerbForm=Part'	treebank='talbanken'
form='samordnad'	lemma='samordna'	feats='Case=Nom|Definite=Ind|Degree=Pos|Gender=Com|Number=Sing|Tense=Past|VerbForm=Part'	treebank='talbanken'
form='anordnad'	lemma='anordna'	feats='Case=Nom|Definite=Ind|Degree=Pos|Gender=Com|Number=Sing|Tense=Past|VerbForm=Part'	treebank='talbanken'
form='anordnade'	lemma='anordna'	feats='Case=Nom|Definite=Ind|Degree=Pos|Number=Plur|Tense=Past|VerbForm=Part'	treebank='talbanken'
form='menade'	lemma='mena'	feats='Case=Nom|Definite=Ind|Degree=Pos|Number=Plur|Tense=Past|VerbForm=Part'	treebank='talbanken'
form='förorenat'	lemma='förorena'	feats='Case=Nom|Definite=Ind|Degree=Pos|Gender=Neut|Number=Sing|Tense=Past|VerbForm=Part'	treebank='talbanken'
form='förenade'	lemma='förena'	feats='Case=Nom|Definite=Ind|Degree=Pos|Number=Plur|Tense=Past|VerbForm=Part'	treebank='talbanken'
form='förenat'	lemma='förena'	feats='Case=Nom|Definite=Ind|Degree=Pos|Gender=Neut|Number=Sing|Tense=Past|VerbForm=Part'	treebank='talbanken'
form='hägnad'	lemma='hägna'	feats='Case=Nom|Definite=Ind|Degree=Pos|Gender=Com|Number=Sing|Tense=Past|VerbForm=Part'	treebank='talbanken'
form='räknat'	lemma='räkna'	feats='Case=Nom|Definite=Ind|Degree=Pos|Gender=Neut|Number=Sing|Tense=Past|VerbForm=Part'	treebank='talbanken'
form='beräknad'	lemma='beräkna'	feats='Case=Nom|Definite=Ind|Degree=Pos|Gender=Com|Number=Sing|Tense=Past|VerbForm=Part'	treebank='talbanken'
form='beräknade'	lemma='beräkna'	feats='Case=Nom|Definite=Def|Degree=Pos|Tense=Past|VerbForm=Part'	treebank='talbanken'
form='beräknat'	lemma='beräkna'	feats='Case=Nom|Definite=Ind|Degree=Pos|Gender=Neut|Number=Sing|Tense=Past|VerbForm=Part'	treebank='talbanken'
form='efterlämnade'	lemma='efterlämna'	feats='Case=Nom|Definite=Ind|Degree=Pos|Number=Plur|Tense=Past|VerbForm=Part'	treebank='talbanken'
form='överlämnad'	lemma='överlämna'	feats='Case=Nom|Definite=Ind|Degree=Pos|Gender=Com|Number=Sing|Tense=Past|VerbForm=Part'	treebank='talbanken'
form='utlämnad'	lemma='utlämna'	feats='Case=Nom|Definite=Ind|Degree=Pos|Gender=Com|Number=Sing|Tense=Past|VerbForm=Part'	treebank='talbanken'
form='utlämnade'	lemma='utlämna'	feats='Case=Nom|Definite=Ind|Degree=Pos|Number=Plur|Tense=Past|VerbForm=Part'	treebank='talbanken'
form='nämnda'	lemma='nämna'	feats='Case=Nom|Number=Plur|Tense=Past|VerbForm=Part'	treebank='talbanken'
form='nämnda'	lemma='nämna'	feats='Case=Nom|Definite=Def|Number=Sing|Tense=Past|VerbForm=Part'	treebank='lines_test'
form='nämnda'	lemma='nämna'	feats='Case=Nom|Definite=Def|Number=Sing|Tense=Past|VerbForm=Part'	treebank='talbanken'
form='vunnet'	lemma='vinna'	feats='Case=Nom|Definite=Ind|Gender=Neut|Number=Sing|Tense=Past|VerbForm=Part'	treebank='talbanken'
form='känt'	lemma='känna'	feats='Case=Nom|Definite=Ind|Gender=Neut|Number=Sing|Tense=Past|VerbForm=Part'	treebank='talbanken'
form='godkända'	lemma='godkänna'	feats='Case=Nom|Number=Plur|Tense=Past|VerbForm=Part'	treebank='talbanken'
form='avlönade'	lemma='avlöna'	feats='Case=Nom|Definite=Ind|Degree=Pos|Number=Plur|Tense=Past|VerbForm=Part'	treebank='talbanken'
form='avlönat'	lemma='avlöna'	feats='Case=Nom|Definite=Ind|Degree=Pos|Gender=Neut|Number=Sing|Tense=Past|VerbForm=Part'	treebank='talbanken'
form='oroad'	lemma='oroa'	feats='Case=Nom|Definite=Ind|Degree=Pos|Gender=Com|Number=Sing|Tense=Past|VerbForm=Part'	treebank='talbanken'
form='skapad'	lemma='skapa'	feats='Case=Nom|Definite=Ind|Degree=Pos|Gender=Com|Number=Sing|Tense=Past|VerbForm=Part'	treebank='talbanken'
form='upprepade'	lemma='upprepa'	feats='Case=Nom|Definite=Def|Degree=Pos|Tense=Past|VerbForm=Part'	treebank='talbanken'
form='dämpade'	lemma='dämpa'	feats='Case=Nom|Definite=Def|Degree=Pos|Tense=Past|VerbForm=Part'	treebank='talbanken'
form='slopad'	lemma='slopa'	feats='Case=Nom|Definite=Ind|Degree=Pos|Gender=Com|Number=Sing|Tense=Past|VerbForm=Part'	treebank='talbanken'
form='slopat'	lemma='slopa'	feats='Case=Nom|Definite=Ind|Degree=Pos|Gender=Neut|Number=Sing|Tense=Past|VerbForm=Part'	treebank='talbanken'
form='slopade'	lemma='slopa'	feats='Case=Nom|Definite=Ind|Degree=Pos|Number=Plur|Tense=Past|VerbForm=Part'	treebank='talbanken'
form='klippta'	lemma='klippa'	feats='Case=Nom|Number=Plur|Tense=Past|VerbForm=Part'	treebank='talbanken'
form='klippt'	lemma='klippa'	feats='Case=Nom|Definite=Ind|Gender=Neut|Number=Sing|Tense=Past|VerbForm=Part'	treebank='talbanken'
form='förknippat'	lemma='förknippa'	feats='Case=Nom|Definite=Ind|Degree=Pos|Gender=Neut|Number=Sing|Tense=Past|VerbForm=Part'	treebank='talbanken'
form='doppad'	lemma='doppa'	feats='Case=Nom|Definite=Ind|Degree=Pos|Gender=Com|Number=Sing|Tense=Past|VerbForm=Part'	treebank='talbanken'
form='fördjupad'	lemma='fördjupa'	feats='Case=Nom|Definite=Ind|Degree=Pos|Gender=Com|Number=Sing|Tense=Past|VerbForm=Part'	treebank='talbanken'
form='omyndigförklarad'	lemma='omyndigförklara'	feats='Case=Nom|Definite=Ind|Degree=Pos|Gender=Com|Number=Sing|Tense=Past|VerbForm=Part'	treebank='talbanken'
form='bevarade'	lemma='bevara'	feats='Case=Nom|Definite=Ind|Degree=Pos|Number=Plur|Tense=Past|VerbForm=Part'	treebank='talbanken'
form='Ändrade'	lemma='ändra'	feats='Case=Nom|Definite=Ind|Degree=Pos|Number=Plur|Tense=Past|VerbForm=Part'	treebank='talbanken'
form='ändrade'	lemma='ändra'	feats='Case=Nom|Definite=Ind|Degree=Pos|Number=Plur|Tense=Past|VerbForm=Part'	treebank='talbanken'
form='förändrade'	lemma='förändra'	feats='Case=Nom|Definite=Def|Degree=Pos|Tense=Past|VerbForm=Part'	treebank='talbanken'
form='förändrad'	lemma='förändra'	feats='Case=Nom|Definite=Ind|Degree=Pos|Gender=Com|Number=Sing|Tense=Past|VerbForm=Part'	treebank='talbanken'
form='förändrat'	lemma='förändra'	feats='Case=Nom|Definite=Ind|Degree=Pos|Gender=Neut|Number=Sing|Tense=Past|VerbForm=Part'	treebank='talbanken'
form='placerad'	lemma='placera'	feats='Case=Nom|Definite=Ind|Degree=Pos|Gender=Com|Number=Sing|Tense=Past|VerbForm=Part'	treebank='talbanken'
form='placerade'	lemma='placera'	feats='Case=Nom|Definite=Ind|Degree=Pos|Number=Plur|Tense=Past|VerbForm=Part'	treebank='talbanken'
form='specificerade'	lemma='specificera'	feats='Case=Nom|Definite=Ind|Degree=Pos|Number=Plur|Tense=Past|VerbForm=Part'	treebank='talbanken'
form='Publicerad'	lemma='publicera'	feats='Case=Nom|Definite=Ind|Degree=Pos|Gender=Com|Number=Sing|Tense=Past|VerbForm=Part'	treebank='talbanken'
form='publicerad'	lemma='publicera'	feats='Case=Nom|Definite=Ind|Degree=Pos|Gender=Com|Number=Sing|Tense=Past|VerbForm=Part'	treebank='talbanken'
form='värderade'	lemma='värdera'	feats='Case=Nom|Definite=Ind|Degree=Pos|Number=Plur|Tense=Past|VerbForm=Part'	treebank='talbanken'
form='nedvärderad'	lemma='nedvärdera'	feats='Case=Nom|Definite=Ind|Degree=Pos|Gender=Com|Number=Sing|Tense=Past|VerbForm=Part'	treebank='talbanken'
form='uppvärderade'	lemma='uppvärdera'	feats='Case=Nom|Definite=Ind|Degree=Pos|Number=Plur|Tense=Past|VerbForm=Part'	treebank='talbanken'
form='regerad'	lemma='regera'	feats='Case=Nom|Definite=Ind|Degree=Pos|Gender=Com|Number=Sing|Tense=Past|VerbForm=Part'	treebank='talbanken'
form='korrugerad'	lemma='korrugera'	feats='Case=Nom|Definite=Ind|Degree=Pos|Gender=Com|Number=Sing|Tense=Past|VerbForm=Part'	treebank='talbanken'
form='intensifierad'	lemma='intensifiera'	feats='Case=Nom|Definite=Ind|Degree=Pos|Gender=Com|Number=Sing|Tense=Past|VerbForm=Part'	treebank='talbanken'
form='differentierade'	lemma='differentiera'	feats='Case=Nom|Definite=Ind|Degree=Pos|Number=Plur|Tense=Past|VerbForm=Part'	treebank='talbanken'
form='möblerade'	lemma='möblera'	feats='Case=Nom|Definite=Ind|Degree=Pos|Number=Plur|Tense=Past|VerbForm=Part'	treebank='talbanken'
form='reglerad'	lemma='reglera'	feats='Case=Nom|Definite=Ind|Degree=Pos|Gender=Com|Number=Sing|Tense=Past|VerbForm=Part'	treebank='talbanken'
form='hyresreglerade'	lemma='hyresreglera'	feats='Case=Nom|Definite=Ind|Degree=Pos|Number=Plur|Tense=Past|VerbForm=Part'	treebank='talbanken'
form='isolerade'	lemma='isolera'	feats='Case=Nom|Definite=Ind|Degree=Pos|Number=Plur|Tense=Past|VerbForm=Part'	treebank='talbanken'
form='stimulerade'	lemma='stimulera'	feats='Case=Nom|Definite=Ind|Degree=Pos|Number=Plur|Tense=Past|VerbForm=Part'	treebank='talbanken'
form='formulerad'	lemma='formulera'	feats='Case=Nom|Definite=Ind|Degree=Pos|Gender=Com|Number=Sing|Tense=Past|VerbForm=Part'	treebank='talbanken'
form='planerad'	lemma='planera'	feats='Case=Nom|Definite=Ind|Degree=Pos|Gender=Com|Number=Sing|Tense=Past|VerbForm=Part'	treebank='talbanken'
form='planerade'	lemma='planera'	feats='Case=Nom|Definite=Ind|Degree=Pos|Number=Plur|Tense=Past|VerbForm=Part'	treebank='talbanken'
form='kombinerad'	lemma='kombinera'	feats='Case=Nom|Definite=Ind|Degree=Pos|Gender=Com|Number=Sing|Tense=Past|VerbForm=Part'	treebank='talbanken'
form='vaccinerad'	lemma='vaccinera'	feats='Case=Nom|Definite=Ind|Degree=Pos|Gender=Com|Number=Sing|Tense=Past|VerbForm=Part'	treebank='talbanken'
form='överdimensionerad'	lemma='överdimensionera'	feats='Case=Nom|Definite=Ind|Degree=Pos|Gender=Com|Number=Sing|Tense=Past|VerbForm=Part'	treebank='talbanken'
form='deponerade'	lemma='deponera'	feats='Case=Nom|Definite=Def|Degree=Pos|Tense=Past|VerbForm=Part'	treebank='talbanken'
form='grupperade'	lemma='gruppera'	feats='Case=Nom|Definite=Ind|Degree=Pos|Number=Plur|Tense=Past|VerbForm=Part'	treebank='talbanken'
form='numrerade'	lemma='numrera'	feats='Case=Nom|Definite=Ind|Degree=Pos|Number=Plur|Tense=Past|VerbForm=Part'	treebank='talbanken'
form='centrerade'	lemma='centrera'	feats='Case=Nom|Definite=Ind|Degree=Pos|Number=Plur|Tense=Past|VerbForm=Part'	treebank='talbanken'
form='koncentrerade'	lemma='koncentrera'	feats='Case=Nom|Definite=Ind|Degree=Pos|Number=Plur|Tense=Past|VerbForm=Part'	treebank='talbanken'
form='koncentrerade'	lemma='koncentrera'	feats='Case=Nom|Definite=Def|Degree=Pos|Tense=Past|VerbForm=Part'	treebank='talbanken'
form='baserat'	lemma='basera'	feats='Case=Nom|Definite=Ind|Degree=Pos|Gender=Neut|Number=Sing|Tense=Past|VerbForm=Part'	treebank='talbanken'
form='baserade'	lemma='basera'	feats='Case=Nom|Definite=Ind|Degree=Pos|Number=Plur|Tense=Past|VerbForm=Part'	treebank='talbanken'
form='standardiserat'	lemma='standardisera'	feats='Case=Nom|Definite=Ind|Degree=Pos|Gender=Neut|Number=Sing|Tense=Past|VerbForm=Part'	treebank='talbanken'
form='legaliserade'	lemma='legalisera'	feats='Case=Nom|Definite=Ind|Degree=Pos|Number=Plur|Tense=Past|VerbForm=Part'	treebank='talbanken'
form='industrialiserade'	lemma='industrialisera'	feats='Case=Nom|Definite=Def|Degree=Pos|Tense=Past|VerbForm=Part'	treebank='talbanken'
form='industrialiserat'	lemma='industrialisera'	feats='Case=Nom|Definite=Ind|Degree=Pos|Gender=Neut|Number=Sing|Tense=Past|VerbForm=Part'	treebank='talbanken'
form='industrialiserade'	lemma='industrialisera'	feats='Case=Nom|Definite=Ind|Degree=Pos|Number=Plur|Tense=Past|VerbForm=Part'	treebank='talbanken'
form='lokaliserade'	lemma='lokalisera'	feats='Case=Nom|Definite=Ind|Degree=Pos|Number=Plur|Tense=Past|VerbForm=Part'	treebank='talbanken'
form='stabiliserat'	lemma='stabilisera'	feats='Case=Nom|Definite=Ind|Degree=Pos|Gender=Neut|Number=Sing|Tense=Past|VerbForm=Part'	treebank='talbanken'
form='koloniserade'	lemma='kolonisera'	feats='Case=Nom|Definite=Ind|Degree=Pos|Number=Plur|Tense=Past|VerbForm=Part'	treebank='talbanken'
form='pulveriserat'	lemma='pulverisera'	feats='Case=Nom|Definite=Ind|Degree=Pos|Gender=Neut|Number=Sing|Tense=Past|VerbForm=Part'	treebank='talbanken'
form='hypnotiserad'	lemma='hypnotisera'	feats='Case=Nom|Definite=Ind|Gender=Com|Number=Sing|Tense=Past|VerbForm=Part'	treebank='lines_dev'
form='adresserade'	lemma='adressera'	feats='Case=Nom|Definite=Ind|Degree=Pos|Number=Plur|Tense=Past|VerbForm=Part'	treebank='talbanken'
form='garanterad'	lemma='garantera'	feats='Case=Nom|Definite=Ind|Degree=Pos|Gender=Com|Number=Sing|Tense=Past|VerbForm=Part'	treebank='talbanken'
form='representerade'	lemma='representera'	feats='Case=Nom|Definite=Ind|Degree=Pos|Number=Plur|Tense=Past|VerbForm=Part'	treebank='talbanken'
form='representerad'	lemma='representera'	feats='Case=Nom|Definite=Ind|Degree=Pos|Gender=Com|Number=Sing|Tense=Past|VerbForm=Part'	treebank='talbanken'
form='noterad'	lemma='notera'	feats='Case=Nom|Definite=Ind|Degree=Pos|Gender=Com|Number=Sing|Tense=Past|VerbForm=Part'	treebank='talbanken'
form='accepterade'	lemma='acceptera'	feats='Case=Nom|Definite=Ind|Degree=Pos|Number=Plur|Tense=Past|VerbForm=Part'	treebank='talbanken'
form='accepterad'	lemma='acceptera'	feats='Case=Nom|Definite=Ind|Degree=Pos|Gender=Com|Number=Sing|Tense=Past|VerbForm=Part'	treebank='talbanken'
form='accepterat'	lemma='acceptera'	feats='Case=Nom|Definite=Ind|Degree=Pos|Gender=Neut|Number=Sing|Tense=Past|VerbForm=Part'	treebank='talbanken'
form='inrapporterade'	lemma='inrapportera'	feats='Case=Nom|Definite=Ind|Degree=Pos|Number=Plur|Tense=Past|VerbForm=Part'	treebank='talbanken'
form='diskuterat'	lemma='diskutera'	feats='Case=Nom|Definite=Ind|Degree=Pos|Gender=Neut|Number=Sing|Tense=Past|VerbForm=Part'	treebank='talbanken'
form='instruerade'	lemma='instruera'	feats='Case=Nom|Definite=Ind|Degree=Pos|Number=Plur|Tense=Past|VerbForm=Part'	treebank='talbanken'
form='taxerad'	lemma='taxera'	feats='Case=Nom|Definite=Ind|Degree=Pos|Gender=Com|Number=Sing|Tense=Past|VerbForm=Part'	treebank='talbanken'
form='taxerade'	lemma='taxera'	feats='Case=Nom|Definite=Def|Degree=Pos|Tense=Past|VerbForm=Part'	treebank='talbanken'
form='lagrad'	lemma='lagra'	feats='Case=Nom|Definite=Ind|Degree=Pos|Gender=Com|Number=Sing|Tense=Past|VerbForm=Part'	treebank='talbanken'
form='stegrade'	lemma='stegra'	feats='Case=Nom|Definite=Ind|Degree=Pos|Number=Plur|Tense=Past|VerbForm=Part'	treebank='talbanken'
form='förankrat'	lemma='förankra'	feats='Case=Nom|Definite=Ind|Degree=Pos|Gender=Neut|Number=Sing|Tense=Past|VerbForm=Part'	treebank='talbanken'
form='försäkrades'	lemma='försäkra'	feats='Case=Gen|Number=Plur|Tense=Past|VerbForm=Part'	treebank='talbanken'
form='försäkrad'	lemma='försäkra'	feats='Case=Nom|Definite=Ind|Degree=Pos|Gender=Com|Number=Sing|Tense=Past|VerbForm=Part'	treebank='talbanken'
form='sjukpenningförsäkrade'	lemma='sjukpenningförsäkra'	feats='Case=Nom|Definite=Ind|Degree=Pos|Number=Plur|Tense=Past|VerbForm=Part'	treebank='talbanken'
form='förlorat'	lemma='förlora'	feats='Case=Nom|Definite=Ind|Degree=Pos|Gender=Neut|Number=Sing|Tense=Past|VerbForm=Part'	treebank='talbanken'
form='förstorade'	lemma='förstora'	feats='Case=Nom|Definite=Ind|Degree=Pos|Number=Plur|Tense=Past|VerbForm=Part'	treebank='talbanken'
form='spärrad'	lemma='spärra'	feats='Case=Nom|Definite=Ind|Degree=Pos|Gender=Com|Number=Sing|Tense=Past|VerbForm=Part'	treebank='talbanken'
form='sintrad'	lemma='sintra'	feats='Case=Nom|Definite=Ind|Degree=Pos|Gender=Com|Number=Sing|Tense=Past|VerbForm=Part'	treebank='talbanken'
form='alstrad'	lemma='alstra'	feats='Case=Nom|Definite=Ind|Degree=Pos|Gender=Com|Number=Sing|Tense=Past|VerbForm=Part'	treebank='talbanken'
form='fostrade'	lemma='fostra'	feats='Case=Nom|Definite=Ind|Degree=Pos|Number=Plur|Tense=Past|VerbForm=Part'	treebank='talbanken'
form='förbättrade'	lemma='förbättra'	feats='Case=Nom|Definite=Ind|Degree=Pos|Number=Plur|Tense=Past|VerbForm=Part'	treebank='talbanken'
form='sårad'	lemma='såra'	feats='Case=Nom|Definite=Ind|Degree=Pos|Gender=Com|Number=Sing|Tense=Past|VerbForm=Part'	treebank='talbanken'
form='tillförd'	lemma='tillföra'	feats='Case=Nom|Definite=Ind|Gender=Com|Number=Sing|Tense=Past|VerbForm=Part'	treebank='talbanken'
form='framförd'	lemma='framföra'	feats='Case=Nom|Definite=Ind|Gender=Com|Number=Sing|Tense=Past|VerbForm=Part'	treebank='talbanken'
form='genomförd'	lemma='genomföra'	feats='Case=Nom|Definite=Ind|Gender=Com|Number=Sing|Tense=Past|VerbForm=Part'	treebank='talbanken'
form='jämfört'	lemma='jämföra'	feats='Case=Nom|Definite=Ind|Gender=Neut|Number=Sing|Tense=Past|VerbForm=Part'	treebank='talbanken'
form='sammanförda'	lemma='sammanföra'	feats='Case=Nom|Number=Plur|Tense=Past|VerbForm=Part'	treebank='talbanken'
form='införd'	lemma='införa'	feats='Case=Nom|Definite=Ind|Gender=Com|Number=Sing|Tense=Past|VerbForm=Part'	treebank='talbanken'
form='införda'	lemma='införa'	feats='Case=Nom|Number=Plur|Tense=Past|VerbForm=Part'	treebank='talbanken'
form='utförda'	lemma='utföra'	feats='Case=Nom|Number=Plur|Tense=Past|VerbForm=Part'	treebank='talbanken'
form='utförd'	lemma='utföra'	feats='Case=Nom|Definite=Ind|Gender=Com|Number=Sing|Tense=Past|VerbForm=Part'	treebank='talbanken'
form='slutförd'	lemma='slutföra'	feats='Case=Nom|Definite=Ind|Gender=Com|Number=Sing|Tense=Past|VerbForm=Part'	treebank='talbanken'
form='gjord'	lemma='göra'	feats='Case=Nom|Definite=Ind|Gender=Com|Number=Sing|Tense=Past|VerbForm=Part'	treebank='talbanken'
form='gjorda'	lemma='göra'	feats='Case=Nom|Number=Plur|Tense=Past|VerbForm=Part'	treebank='talbanken'
form='nyttiggjorda'	lemma='nyttiggöra'	feats='Case=Nom|Number=Plur|Tense=Past|VerbForm=Part'	treebank='talbanken'
form='rengjord'	lemma='rengöra'	feats='Case=Nom|Definite=Ind|Gender=Com|Number=Sing|Tense=Past|VerbForm=Part'	treebank='talbanken'
form='störd'	lemma='störa'	feats='Case=Nom|Definite=Ind|Gender=Com|Number=Sing|Tense=Past|VerbForm=Part'	treebank='talbanken'
form='störda'	lemma='störa'	feats='Case=Nom|Number=Plur|Tense=Past|VerbForm=Part'	treebank='talbanken'
form='hänvisade'	lemma='hänvisa'	feats='Case=Nom|Definite=Ind|Degree=Pos|Number=Plur|Tense=Past|VerbForm=Part'	treebank='talbanken'
form='hänvisad'	lemma='hänvisa'	feats='Case=Nom|Definite=Ind|Degree=Pos|Gender=Com|Number=Sing|Tense=Past|VerbForm=Part'	treebank='talbanken'
form='redovisade'	lemma='redovisa'	feats='Case=Nom|Definite=Ind|Degree=Pos|Number=Plur|Tense=Past|VerbForm=Part'	treebank='talbanken'
form='anpassad'	lemma='anpassa'	feats='Case=Nom|Definite=Ind|Degree=Pos|Gender=Com|Number=Sing|Tense=Past|VerbForm=Part'	treebank='talbanken'
form='anpassade'	lemma='anpassa'	feats='Case=Nom|Definite=Ind|Degree=Pos|Number=Plur|Tense=Past|VerbForm=Part'	treebank='talbanken'
form='anpassat'	lemma='anpassa'	feats='Case=Nom|Definite=Ind|Degree=Pos|Gender=Neut|Number=Sing|Tense=Past|VerbForm=Part'	treebank='talbanken'
form='belyst'	lemma='belysa'	feats='Case=Nom|Definite=Ind|Gender=Com|Number=Sing|Tense=Past|VerbForm=Part'	treebank='talbanken'
form='frusen'	lemma='frysa'	feats='Case=Nom|Definite=Ind|Gender=Com|Number=Sing|Tense=Past|VerbForm=Part'	treebank='talbanken'
form='djupfryst'	lemma='djupfrysa'	feats='Case=Nom|Definite=Ind|Gender=Com|Number=Sing|Tense=Past|VerbForm=Part'	treebank='talbanken'
form='låsta'	lemma='låsa'	feats='Case=Nom|Number=Plur|Tense=Past|VerbForm=Part'	treebank='talbanken'
form='låst'	lemma='låsa'	feats='Case=Nom|Definite=Ind|Gender=Com|Number=Sing|Tense=Past|VerbForm=Part'	treebank='talbanken'
form='löst'	lemma='lösa'	feats='Case=Nom|Definite=Ind|Gender=Com|Number=Sing|Tense=Past|VerbForm=Part'	treebank='talbanken'
form='förtretad'	lemma='förtreta'	feats='Case=Nom|Definite=Ind|Degree=Pos|Gender=Com|Number=Sing|Tense=Past|VerbForm=Part'	treebank='talbanken'
form='skaftad'	lemma='skafta'	feats='Case=Nom|Definite=Ind|Degree=Pos|Gender=Com|Number=Sing|Tense=Past|VerbForm=Part'	treebank='talbanken'
form='gifta'	lemma='gifta'	feats='Case=Nom|Number=Plur|Tense=Past|VerbForm=Part'	treebank='talbanken'
form='stiftat'	lemma='stifta'	feats='Case=Nom|Definite=Ind|Degree=Pos|Gender=Neut|Number=Sing|Tense=Past|VerbForm=Part'	treebank='talbanken'
form='instiftat'	lemma='instifta'	feats='Case=Nom|Definite=Ind|Degree=Pos|Gender=Neut|Number=Sing|Tense=Past|VerbForm=Part'	treebank='talbanken'
form='icke-vita'	lemma='icke-vita'	feats='Case=Nom|Definite=Def|Number=Sing|Tense=Past|VerbForm=Part'	treebank='pud'
form='aktade'	lemma='akta'	feats='Case=Nom|Definite=Ind|Degree=Pos|Number=Plur|Tense=Past|VerbForm=Part'	treebank='talbanken'
form='eftertraktad'	lemma='eftertrakta'	feats='Case=Nom|Definite=Ind|Degree=Pos|Gender=Com|Number=Sing|Tense=Past|VerbForm=Part'	treebank='talbanken'
form='eftertraktade'	lemma='eftertrakta'	feats='Case=Nom|Definite=Ind|Degree=Pos|Number=Plur|Tense=Past|VerbForm=Part'	treebank='talbanken'
form='inriktad'	lemma='inrikta'	feats='Case=Nom|Definite=Ind|Degree=Pos|Gender=Com|Number=Sing|Tense=Past|VerbForm=Part'	treebank='talbanken'
form='Avsaltat'	lemma='avsalta'	feats='Case=Nom|Definite=Ind|Degree=Pos|Gender=Neut|Number=Sing|Tense=Past|VerbForm=Part'	treebank='talbanken'
form='hämtat'	lemma='hämta'	feats='Case=Nom|Definite=Ind|Degree=Pos|Gender=Neut|Number=Sing|Tense=Past|VerbForm=Part'	treebank='talbanken'
form='hämtade'	lemma='hämta'	feats='Case=Nom|Definite=Ind|Degree=Pos|Number=Plur|Tense=Past|VerbForm=Part'	treebank='talbanken'
form='antagna'	lemma='anta'	feats='Case=Nom|Definite=Def|Number=Sing|Tense=Past|VerbForm=Part'	treebank='talbanken'
form='undantagen'	lemma='undanta'	feats='Case=Nom|Definite=Ind|Gender=Com|Number=Sing|Tense=Past|VerbForm=Part'	treebank='talbanken'
form='väntade'	lemma='vänta'	feats='Case=Nom|Definite=Ind|Degree=Pos|Number=Plur|Tense=Past|VerbForm=Part'	treebank='talbanken'
form='väntade'	lemma='vänta'	feats='Case=Nom|Definite=Def|Degree=Pos|Tense=Past|VerbForm=Part'	treebank='talbanken'
form='underkastade'	lemma='underkasta'	feats='Case=Nom|Definite=Ind|Degree=Pos|Number=Plur|Tense=Past|VerbForm=Part'	treebank='talbanken'
form='underkastat'	lemma='underkasta'	feats='Case=Nom|Definite=Ind|Degree=Pos|Gender=Neut|Number=Sing|Tense=Past|VerbForm=Part'	treebank='talbanken'
form='utrustade'	lemma='utrusta'	feats='Case=Nom|Definite=Ind|Degree=Pos|Number=Plur|Tense=Past|VerbForm=Part'	treebank='talbanken'
form='utrustad'	lemma='utrusta'	feats='Case=Nom|Definite=Ind|Degree=Pos|Gender=Com|Number=Sing|Tense=Past|VerbForm=Part'	treebank='talbanken'
form='stadfästa'	lemma='stadfästa'	feats='Case=Nom|Number=Plur|Tense=Past|VerbForm=Part'	treebank='talbanken'
form='stadfäst'	lemma='stadfästa'	feats='Case=Nom|Definite=Ind|Gender=Com|Number=Sing|Tense=Past|VerbForm=Part'	treebank='talbanken'
form='omfattad'	lemma='omfatta'	feats='Case=Nom|Definite=Ind|Degree=Pos|Gender=Com|Number=Sing|Tense=Past|VerbForm=Part'	treebank='talbanken'
form='inflyttad'	lemma='inflytta'	feats='Case=Nom|Definite=Ind|Degree=Pos|Gender=Com|Number=Sing|Tense=Past|VerbForm=Part'	treebank='talbanken'
form='inrättat'	lemma='inrätta'	feats='Case=Nom|Definite=Ind|Degree=Pos|Gender=Neut|Number=Sing|Tense=Past|VerbForm=Part'	treebank='talbanken'
form='nedsatt'	lemma='nedsätta'	feats='Case=Nom|Definite=Ind|Gender=Com|Number=Sing|Tense=Past|VerbForm=Part'	treebank='talbanken'
form='sysselsatt'	lemma='sysselsätta'	feats='Case=Nom|Definite=Ind|Gender=Neut|Number=Sing|Tense=Past|VerbForm=Part'	treebank='talbanken'
form='sysselsatta'	lemma='sysselsätta'	feats='Case=Nom|Number=Plur|Tense=Past|VerbForm=Part'	treebank='talbanken'
form='omsatt'	lemma='omsätta'	feats='Case=Nom|Definite=Ind|Gender=Com|Number=Sing|Tense=Past|VerbForm=Part'	treebank='talbanken'
form='översatta'	lemma='översätta'	feats='Case=Nom|Number=Plur|Tense=Past|VerbForm=Part'	treebank='talbanken'
form='fortsatta'	lemma='fortsätta'	feats='Case=Nom|Number=Plur|Tense=Past|VerbForm=Part'	treebank='talbanken'
form='fortsatt'	lemma='fortsätta'	feats='Case=Nom|Definite=Ind|Gender=Com|Number=Sing|Tense=Past|VerbForm=Part'	treebank='talbanken'
form='fortsatta'	lemma='fortsätta'	feats='Case=Nom|Definite=Def|Number=Sing|Tense=Past|VerbForm=Part'	treebank='talbanken'
form='fortsatt'	lemma='fortsätta'	feats='Case=Nom|Definite=Ind|Gender=Neut|Number=Sing|Tense=Past|VerbForm=Part'	treebank='talbanken'
form='utsatt'	lemma='utsätta'	feats='Case=Nom|Definite=Ind|Gender=Com|Number=Sing|Tense=Past|VerbForm=Part'	treebank='talbanken'
form='utsatta'	lemma='utsätta'	feats='Case=Nom|Number=Plur|Tense=Past|VerbForm=Part'	treebank='talbanken'
form='uppskjutet'	lemma='uppskjuta'	feats='Case=Nom|Definite=Ind|Gender=Neut|Number=Sing|Tense=Past|VerbForm=Part'	treebank='talbanken'
form='Uppskjutet'	lemma='uppskjuta'	feats='Case=Nom|Definite=Ind|Gender=Neut|Number=Sing|Tense=Past|VerbForm=Part'	treebank='talbanken'
form='anslutet'	lemma='ansluta'	feats='Case=Nom|Definite=Ind|Gender=Neut|Number=Sing|Tense=Past|VerbForm=Part'	treebank='talbanken'
form='anslutna'	lemma='ansluta'	feats='Case=Nom|Number=Plur|Tense=Past|VerbForm=Part'	treebank='talbanken'
form='förslutet'	lemma='försluta'	feats='Case=Nom|Definite=Ind|Gender=Neut|Number=Sing|Tense=Past|VerbForm=Part'	treebank='talbanken'
form='knuten'	lemma='knyta'	feats='Case=Nom|Definite=Ind|Gender=Com|Number=Sing|Tense=Past|VerbForm=Part'	treebank='talbanken'
form='knutna'	lemma='knyta'	feats='Case=Nom|Number=Plur|Tense=Past|VerbForm=Part'	treebank='talbanken'
form='skött'	lemma='sköta'	feats='Case=Nom|Definite=Ind|Gender=Com|Number=Sing|Tense=Past|VerbForm=Part'	treebank='talbanken'
form='intervjuad'	lemma='intervjua'	feats='Case=Nom|Definite=Ind|Degree=Pos|Gender=Com|Number=Sing|Tense=Past|VerbForm=Part'	treebank='talbanken'
form='upplevda'	lemma='uppleva'	feats='Case=Nom|Definite=Def|Number=Sing|Tense=Past|VerbForm=Part'	treebank='talbanken'
form='skrivet'	lemma='skriva'	feats='Case=Nom|Definite=Ind|Gender=Neut|Number=Sing|Tense=Past|VerbForm=Part'	treebank='talbanken'
form='beskriven'	lemma='beskriva'	feats='Case=Nom|Definite=Ind|Gender=Com|Number=Sing|Tense=Past|VerbForm=Part'	treebank='talbanken'
form='beskrivna'	lemma='beskriva'	feats='Case=Nom|Definite=Def|Number=Sing|Tense=Past|VerbForm=Part'	treebank='talbanken'
form='inskriven'	lemma='inskriva'	feats='Case=Nom|Definite=Ind|Gender=Com|Number=Sing|Tense=Past|VerbForm=Part'	treebank='talbanken'
form='kluven'	lemma='klyva'	feats='Case=Nom|Definite=Ind|Gender=Com|Number=Sing|Tense=Past|VerbForm=Part'	treebank='talbanken'
form='eftersträvade'	lemma='eftersträva'	feats='Case=Nom|Definite=Def|Degree=Pos|Tense=Past|VerbForm=Part'	treebank='talbanken'
form='inkomstprövat'	lemma='inkomstpröva'	feats='Case=Nom|Definite=Ind|Degree=Pos|Gender=Neut|Number=Sing|Tense=Past|VerbForm=Part'	treebank='talbanken'
form='inkomstprövad'	lemma='inkomstpröva'	feats='Case=Nom|Definite=Ind|Degree=Pos|Gender=Com|Number=Sing|Tense=Past|VerbForm=Part'	treebank='talbanken'

feats='Case=Nom|Definite=Def|Number=Sing|Tense=Past|VerbForm=Part'	treebank='pud'
feats='Case=Nom|Definite=Ind|Gender=Com|Number=Sing|Tense=Past|VerbForm=Part'	treebank='talbanken'
feats='Case=Nom|Definite=Ind|Degree=Pos|Gender=Neut|Number=Sing|Tense=Past|VerbForm=Part'	treebank='talbanken'
feats='Case=Nom|Definite=Ind|Degree=Pos|Number=Plur|Tense=Past|VerbForm=Part'	treebank='talbanken'
feats='Case=Nom|Definite=Ind|Gender=Neut|Number=Sing|Tense=Past|VerbForm=Part'	treebank='talbanken'
feats='Case=Nom|Number=Plur|Tense=Past|VerbForm=Part'	treebank='talbanken'
feats='Case=Nom|Definite=Def|Degree=Pos|Tense=Past|VerbForm=Part'	treebank='talbanken'
feats='Case=Gen|Number=Plur|Tense=Past|VerbForm=Part'	treebank='talbanken'
feats='Case=Nom|Definite=Ind|Degree=Pos|Gender=Com|Number=Sing|Tense=Past|VerbForm=Part'	treebank='talbanken'
feats='Case=Nom|Definite=Def|Number=Sing|Tense=Past|VerbForm=Part'	treebank='talbanken'
feats='Case=Nom|Number=Plur|Tense=Past|VerbForm=Part'	treebank='lines_test'
feats='Case=Nom|Definite=Def|Number=Sing|Tense=Past|VerbForm=Part'	treebank='lines_test'
feats='Case=Nom|Definite=Ind|Gender=Com|Number=Sing|Tense=Past|VerbForm=Part'	treebank='lines_test'
feats='Case=Nom|Definite=Ind|Gender=Com|Number=Sing|Tense=Past|VerbForm=Part'	treebank='lines_dev'
