Lemma='accepterad'	Past
Lemma='ackumulerad'	Past
Lemma='adresserad'	Past
Lemma='agerande'	Pres
Lemma='aktad'	Past
Lemma='akvarelltonad'	No
Lemma='alarmerande'	Pres
Lemma='allierad'	Past
Lemma='alstrad'	Past
Lemma='altarliknande'	No
Lemma='ambulerande'	Pres
Lemma='angelägen'	No
Lemma='angelägen'	No
Lemma='angiven'	Past
Lemma='angränsande'	No
Lemma='anklagad'	Past
Lemma='ankommande'	Pres
Lemma='anlagd'	Past
Lemma='anmäld'	Past
Lemma='annalkande'	No
Lemma='anordnad'	Past
Lemma='anordnad'	Past
Lemma='anpassad'	Past
Lemma='anrikad'	Past
Lemma='ansluten'	Past
Lemma='ansluten'	Past
Lemma='anställd'	Past
Lemma='ansvarskännande'	No
Lemma='antagen'	Past
Lemma='använd'	Past
Lemma='aptitnedsättande'	No
Lemma='arbetande'	Pres
Lemma='arbetsanmäld'	No
Lemma='arbetskrävande'	No
Lemma='arbetssökande'	No
Lemma='artikulerad'	Past
Lemma='asfalterad'	Past
Lemma='attraherande'	Pres
Lemma='auktoritetsbunden'	No
Lemma='avancerad'	Past
Lemma='avemotionaliserad'	No
Lemma='avgiven'	Past
Lemma='avgående'	Pres
Lemma='avgörande'	Pres
Lemma='avklarad'	Past
Lemma='avkopplad'	Past
Lemma='avlagd'	Past
Lemma='avliden'	Past
Lemma='avlutad'	Past
Lemma='avlägsen'	No
Lemma='avlönad'	Past
Lemma='avsaktande'	No
Lemma='avsaltad'	Past
Lemma='avsedd'	Past
Lemma='avskedad'	Past
Lemma='avskild'	Past
Lemma='avskruvad'	No
Lemma='avskräckande'	Pres
Lemma='avskuren'	Past
Lemma='avslappnad'	Past
Lemma='avsliten'	No
Lemma='avsmalnande'	Pres
Lemma='avsänd'	Past
Lemma='avtacklad'	No
Lemma='avtalad'	Past
Lemma='avtrubbad'	Past
Lemma='avverkad'	Past
Lemma='avvikande'	Pres
Lemma='avvisande'	Pres
Lemma='bagatellartad'	No
Lemma='bakbunden'	Past
Lemma='bakomliggande'	No
Lemma='bakåtlutad'	No
Lemma='balanserad'	Past
Lemma='balanserande'	Pres
Lemma='barnafödande'	No
Lemma='barnalstrande'	No
Lemma='barnavårdande'	No
Lemma='barncentrerad'	No
Lemma='barskrapad'	No
Lemma='baserad'	Past
Lemma='bedövande'	Pres
Lemma='befolkad'	Past
Lemma='befriad'	Past
Lemma='befriande'	Pres
Lemma='befrämjande'	Pres
Lemma='begagnad'	Past
Lemma='begränsad'	Past
Lemma='begränsande'	Pres
Lemma='begynnande'	Pres
Lemma='begåvad'	Past
Lemma='behärskad'	Past
Lemma='behövande'	Pres
Lemma='beklämmande'	No
Lemma='bekymrad'	Past
Lemma='belevad'	No
Lemma='belyst'	Past
Lemma='belägen'	No
Lemma='belåten'	No
Lemma='benägen'	No
Lemma='beprövad'	No
Lemma='beredd'	Past
Lemma='beriden'	No
Lemma='berikande'	Pres
Lemma='beroende'	Pres
Lemma='berusad'	Past
Lemma='beräknad'	Past
Lemma='beräknad'	Past
Lemma='berättigad'	Past
Lemma='berömd'	Past
Lemma='berörd'	Past
Lemma='beseglad'	Past
Lemma='besegrad'	Past
Lemma='beskaffad'	No
Lemma='beskriven'	Past
Lemma='beskriven'	Past
Lemma='beskyddad'	Past
Lemma='besluten'	No
Lemma='besläktad'	No
Lemma='bestämd'	Past
Lemma='bestämmande'	Pres
Lemma='bestående'	Pres
Lemma='besvarad'	Past
Lemma='besviken'	No
Lemma='besvärande'	Pres
Lemma='betald'	Past
Lemma='betecknande'	Pres
Lemma='betingad'	Past
Lemma='betonad'	Past
Lemma='betryggande'	Pres
Lemma='betungande'	Pres
Lemma='betydande'	Pres
Lemma='bevakad'	Past
Lemma='bevarad'	Past
Lemma='beviljad'	Past
Lemma='beväpnad'	Past
Lemma='bibehållen'	No
Lemma='bildad'	Past
Lemma='bindande'	Pres
Lemma='bisulfitbehandlad'	No
Lemma='bitande'	Pres
Lemma='biträdande'	Pres
Lemma='blandad'	Past
Lemma='blivande'	Pres
Lemma='blixtrande'	Pres
Lemma='blodfläckad'	No
Lemma='blomstrande'	Pres
Lemma='bländande'	Pres
Lemma='blänkande'	Pres
Lemma='blåslagen'	No
Lemma='bortglömd'	No
Lemma='bortkommen'	No
Lemma='bortsedd'	Past
Lemma='bosatt'	Past
Lemma='bostadssökande'	No
Lemma='botande'	Pres
Lemma='bottnande'	Pres
Lemma='brinnande'	Pres
Lemma='briserande'	Pres
Lemma='bristande'	Pres
Lemma='broderad'	Past
Lemma='brummande'	Pres
Lemma='brännande'	Pres
Lemma='brådskande'	Pres
Lemma='bunden'	Past
Lemma='byggd'	Past
Lemma='bärande'	Pres
Lemma='bärgad'	Past
Lemma='centrerad'	Past
Lemma='chockad'	Past
Lemma='chockerande'	Pres
Lemma='choklad'	No
Lemma='civiliserad'	Past
Lemma='dansande'	Pres
Lemma='databehandlad'	No
Lemma='datastyrd'	No
Lemma='definierad'	Past
Lemma='delad'	Past
Lemma='deponerad'	Past
Lemma='deprimerad'	Past
Lemma='designad'	Past
Lemma='detaljerad'	No
Lemma='differentierad'	Past
Lemma='disciplinerad'	Past
Lemma='diskuterad'	Past
Lemma='distingerad'	No
Lemma='djupfryst'	Past
Lemma='djupgående'	No
Lemma='djupnande'	Pres
Lemma='doftande'	Pres
Lemma='dokumenterad'	Past
Lemma='dold'	Past
Lemma='dominerande'	Pres
Lemma='doppad'	Past
Lemma='dragen'	Past
Lemma='driven'	Past
Lemma='dubbad'	Past
Lemma='dubbelarbetande'	Pres
Lemma='dubblerad'	Past
Lemma='dukad'	Past
Lemma='dunkande'	Pres
Lemma='dämpad'	Past
Lemma='dämpande'	Pres
Lemma='dånande'	Pres
Lemma='dåvarande'	No
Lemma='dödad'	Past
Lemma='dödsliknande'	No
Lemma='dömd'	Past
Lemma='eec-associerad'	No
Lemma='efterföljande'	Pres
Lemma='efterkommande'	Pres
Lemma='efterlämnad'	Past
Lemma='efterlängtad'	No
Lemma='eftersläpande'	No
Lemma='eftersträvad'	Past
Lemma='eftertraktad'	Past
Lemma='eftertraktad'	Past
Lemma='egen'	No
Lemma='egen'	No
Lemma='egenskapad'	No
Lemma='eggande'	Pres
Lemma='enastående'	No
Lemma='endogen'	No
Lemma='energikrävande'	No
Lemma='enerverande'	Pres
Lemma='engagerad'	Past
Lemma='enkönad'	No
Lemma='ensamstående'	No
Lemma='erfaren'	Past
Lemma='erövrad'	Past
Lemma='existerande'	Pres
Lemma='expanderande'	Pres
Lemma='exponerad'	Past
Lemma='fabriksskalad'	No
Lemma='fackadresserad'	No
Lemma='fallen'	Past
Lemma='fantasieggande'	No
Lemma='farsartad'	No
Lemma='fascinerande'	Pres
Lemma='fastslagen'	Past
Lemma='fastställd'	Past
Lemma='fastvuxen'	No
Lemma='fattad'	Past
Lemma='feriearbetande'	No
Lemma='fernissad'	Past
Lemma='filmad'	Past
Lemma='filoberoende'	No
Lemma='filtrerad'	Past
Lemma='filtrerad'	Past
Lemma='finansierad'	Past
Lemma='finsktalande'	No
Lemma='finskuren'	No
Lemma='finskuren'	No
Lemma='fixerad'	Past
Lemma='fladdermusliknande'	No
Lemma='fladdrande'	Pres
Lemma='flagnande'	Pres
Lemma='flygande'	Pres
Lemma='flytande'	Pres
Lemma='flyttad'	Past
Lemma='flyttande'	Pres
Lemma='flämtande'	Pres
Lemma='flåsande'	Pres
Lemma='formad'	Past
Lemma='formulerad'	Past
Lemma='forskande'	Pres
Lemma='fortgående'	Pres
Lemma='fortsatt'	Past
Lemma='fortskridande'	Pres
Lemma='fostrad'	Past
Lemma='framförd'	Past
Lemma='framlagd'	Past
Lemma='framräknad'	No
Lemma='framställd'	Past
Lemma='framstående'	Pres
Lemma='framträdande'	Pres
Lemma='framtågande'	No
Lemma='framvällande'	No
Lemma='fredad'	Past
Lemma='frestande'	Pres
Lemma='fristående'	No
Lemma='friterad'	Past
Lemma='frusen'	Past
Lemma='främmande'	No
Lemma='frågande'	Pres
Lemma='frånsedd'	Past
Lemma='frånskild'	Past
Lemma='frånvarande'	Pres
Lemma='fulldubbad'	No
Lemma='fullpackad'	No
Lemma='fulländad'	Past
Lemma='fylld'	Past
Lemma='färdiglagad'	No
Lemma='färdigräknad'	No
Lemma='färdigställd'	Past
Lemma='färgad'	Past
Lemma='färgglad'	No
Lemma='fångad'	Past
Lemma='fårad'	No
Lemma='född'	Past
Lemma='följande'	Pres
Lemma='följd'	Past
Lemma='förankrad'	Past
Lemma='förargad'	Past
Lemma='förargande'	Pres
Lemma='förbannad'	Past
Lemma='förbaskad'	No
Lemma='förberedande'	Pres
Lemma='förberedd'	Past
Lemma='förbiilande'	No
Lemma='förbjuden'	Past
Lemma='förblivande'	Pres
Lemma='förbluffad'	Past
Lemma='förbrukad'	Past
Lemma='förbryllad'	Past
Lemma='förbryllande'	Pres
Lemma='förbunden'	Past
Lemma='förbättrad'	Past
Lemma='fördefinierad'	No
Lemma='fördelad'	Past
Lemma='fördjupad'	Past
Lemma='fördröjd'	Past
Lemma='fördubblad'	Past
Lemma='fördärvad'	Past
Lemma='förebyggande'	Pres
Lemma='föregående'	Pres
Lemma='förekommande'	Pres
Lemma='föreliggande'	Pres
Lemma='förenad'	Past
Lemma='förenande'	Pres
Lemma='förenklad'	Past
Lemma='föreslagen'	Past
Lemma='förestående'	Pres
Lemma='förfinad'	Past
Lemma='förfluten'	Past
Lemma='förfärande'	Pres
Lemma='förgrovande'	Pres
Lemma='förhastad'	Past
Lemma='förhärjande'	Pres
Lemma='förhärskande'	Pres
Lemma='förknippad'	Past
Lemma='förkrossande'	Pres
Lemma='förlegad'	No
Lemma='förlorad'	Past
Lemma='förlängd'	Past
Lemma='förmögen'	No
Lemma='förnedrande'	Pres
Lemma='förnärmad'	Pres
Lemma='förolämpande'	Pres
Lemma='förorenad'	Past
Lemma='förorsakad'	Past
Lemma='förpliktande'	Pres
Lemma='försakad'	Past
Lemma='försedd'	Past
Lemma='försjunken'	Past
Lemma='förslagsställande'	No
Lemma='försluten'	Past
Lemma='försonande'	Pres
Lemma='förstorad'	Past
Lemma='förstulen'	No
Lemma='försvinnande'	Pres
Lemma='försäkrad'	Past
Lemma='förtjusande'	Pres
Lemma='förtretad'	Past
Lemma='förtroendeväckande'	No
Lemma='förtrogen'	No
Lemma='förtrollad'	Past
Lemma='förtvivlad'	Past
Lemma='förutfattad'	No
Lemma='förutsatt'	Past
Lemma='förutseende'	Pres
Lemma='förutvarande'	No
Lemma='förverkligad'	Past
Lemma='förvirrad'	Past
Lemma='förvirrande'	Pres
Lemma='förvriden'	Past
Lemma='förvänd'	Past
Lemma='förväntad'	Past
Lemma='förvärvad'	Past
Lemma='förvärvsarbetande'	Pres
Lemma='förvånad'	Past
Lemma='förvånande'	Pres
Lemma='förädlad'	Past
Lemma='förälskad'	Past
Lemma='förändrad'	Past
Lemma='föråldrad'	No
Lemma='förödande'	Pres
Lemma='galen'	No
Lemma='garanterad'	Past
Lemma='gedigen'	No
Lemma='generad'	Past
Lemma='genomförd'	Past
Lemma='genomgripande'	No
Lemma='genomträngande'	Pres
Lemma='genomtänkt'	No
Lemma='genskjuten'	Past
Lemma='gift'	Past
Lemma='givande'	Pres
Lemma='given'	Past
Lemma='gjord'	Past
Lemma='glad'	No
Lemma='glimmande'	Pres
Lemma='glittrande'	Pres
Lemma='glädjande'	Pres
Lemma='glänsande'	Pres
Lemma='gnistrande'	Pres
Lemma='godhjärtad'	No
Lemma='godkänd'	Past
Lemma='golden'	No
Lemma='grillad'	Past
Lemma='grimaserande'	Pres
Lemma='grundad'	Past
Lemma='grundande'	Pres
Lemma='grundläggande'	Pres
Lemma='grupperad'	Past
Lemma='gränsöverskridande'	No
Lemma='grånad'	Past
Lemma='grönfodrad'	No
Lemma='grönskande'	Pres
Lemma='gudsgiven'	No
Lemma='gällande'	Pres
Lemma='gästande'	Pres
Lemma='gående'	Pres
Lemma='gången'	Past
Lemma='halsbrytande'	No
Lemma='halvskyddad'	No
Lemma='halvvuxen'	No
Lemma='halvöppen'	No
Lemma='handikappad'	Past
Lemma='hanterad'	Past
Lemma='harmsen'	No
Lemma='hasande'	Pres
Lemma='havande'	Pres
Lemma='heldragen'	No
Lemma='helgjuten'	No
Lemma='heltidsarbetande'	Pres
Lemma='hemarbetande'	No
Lemma='hemligstämplad'	Past
Lemma='hemmavarande'	No
Lemma='hittillsvarande'	No
Lemma='hjälpande'	Pres
Lemma='hoande'	Pres
Lemma='hopblandad'	No
Lemma='hopklumpad'	No
Lemma='hotande'	Pres
Lemma='humör-ändrande'	No
Lemma='hycklad'	Past
Lemma='hycklande'	Pres
Lemma='hydrogenererad'	No
Lemma='hyllad'	Past
Lemma='hypnotiserad'	Past
Lemma='hyresreglerad'	No
Lemma='häckande'	Pres
Lemma='hägnad'	Past
Lemma='hämmande'	Pres
Lemma='hämnande'	Pres
Lemma='hämtad'	Past
Lemma='hängande'	Pres
Lemma='hängiven'	Past
Lemma='hänvisad'	Past
Lemma='hänvisad'	Past
Lemma='häpen'	No
Lemma='häpnadsväckande'	No
Lemma='härledd'	Past
Lemma='hästliknande'	No
Lemma='hållen'	Past
Lemma='hårdnackad'	No
Lemma='högavkastande'	No
Lemma='högavlönad'	No
Lemma='högmekaniserad'	No
Lemma='högrenad'	No
Lemma='högtsmällande'	No
Lemma='höjd'	Past
Lemma='höjd'	Past
Lemma='hökliknande'	No
Lemma='iakttagande'	Pres
Lemma='idealiserad'	Past
Lemma='ifylld'	No
Lemma='igenisad'	No
Lemma='igenkänd'	Past
Lemma='ihopläkt'	No
Lemma='ihållande'	No
Lemma='illuminerad'	Past
Lemma='ilsken'	No
Lemma='imponerande'	Pres
Lemma='importerad'	Past
Lemma='improviserad'	Past
Lemma='inbjuden'	Past
Lemma='inblandad'	Past
Lemma='inbäddad'	Past
Lemma='indelad'	Past
Lemma='indignerad'	No
Lemma='indragen'	Past
Lemma='industrialiserad'	Past
Lemma='industriskalad'	No
Lemma='industriskalad'	No
Lemma='inflammerad'	Past
Lemma='inflyttad'	Past
Lemma='införd'	Past
Lemma='ingående'	Pres
Lemma='ingången'	Past
Lemma='inkapslad'	Past
Lemma='inkomstprövad'	No
Lemma='inkomstskapande'	No
Lemma='inlagd'	Past
Lemma='inledd'	Past
Lemma='inlärd'	Past
Lemma='inneboende'	No
Lemma='innehållande'	Pres
Lemma='innestående'	No
Lemma='inpräglad'	Past
Lemma='inrapporterad'	Past
Lemma='inriktad'	Past
Lemma='inrutad'	Past
Lemma='inräknad'	Past
Lemma='inrättad'	Past
Lemma='insjunken'	No
Lemma='inskriven'	Past
Lemma='inskränkande'	Pres
Lemma='inspirerad'	Past
Lemma='installerad'	Past
Lemma='instiftad'	Past
Lemma='instruerad'	Past
Lemma='inställd'	Past
Lemma='insättande'	Pres
Lemma='intagen'	Past
Lemma='integrerad'	Past
Lemma='intensifierad'	Past
Lemma='intervjuad'	Past
Lemma='intetsägande'	No
Lemma='intresserad'	Past
Lemma='invand'	No
Lemma='invecklad'	Past
Lemma='invigd'	Past
Lemma='irriterad'	Past
Lemma='irriterande'	Pres
Lemma='isolerad'	Past
Lemma='iögonenfallande'	No
Lemma='iögonfallande'	No
Lemma='jämförd'	Past
Lemma='jätteglad'	No
Lemma='kalkylbladsliknande'	No
Lemma='kallad'	Past
Lemma='kanderad'	Past
Lemma='kasserad'	Past
Lemma='kerubliknande'	No
Lemma='klarläggande'	Pres
Lemma='klen'	No
Lemma='kliande'	Pres
Lemma='klingande'	Pres
Lemma='klippt'	Past
Lemma='kluven'	Past
Lemma='knorrande'	Pres
Lemma='knuten'	Past
Lemma='kokt'	Past
Lemma='kolbaserad'	No
Lemma='koldriven'	No
Lemma='koleldad'	No
Lemma='koloniserad'	Past
Lemma='kolsyrad'	No
Lemma='kombinerad'	Past
Lemma='kommande'	Pres
Lemma='kompletteringsdubbad'	No
Lemma='komplicerad'	Past
Lemma='koncentrerad'	Past
Lemma='konkurrensbegränsad'	No
Lemma='konstlad'	No
Lemma='konstruerad'	Past
Lemma='kontaktförmögen'	No
Lemma='kontrollerande'	Pres
Lemma='konverterad'	Past
Lemma='korrugerad'	Past
Lemma='korsande'	Pres
Lemma='kortlivad'	No
Lemma='kortsnaggad'	No
Lemma='kortvuxen'	No
Lemma='kostnadshöjande'	No
Lemma='kringgärdad'	Past
Lemma='kringgående'	Pres
Lemma='kringskären'	No
Lemma='kristen'	No
Lemma='krumryggad'	No
Lemma='krympande'	Pres
Lemma='kränkande'	Pres
Lemma='krävande'	Pres
Lemma='kultiverad'	Past
Lemma='kulturorienterande'	No
Lemma='kvalificerad'	Past
Lemma='kvardröjande'	No
Lemma='kvarstående'	Pres
Lemma='kvinnodominerad'	No
Lemma='kvällsarbetande'	No
Lemma='kvävefixerande'	No
Lemma='känd'	Past
Lemma='könsdiskriminerande'	No
Lemma='könsrelaterad'	No
Lemma='könsrollspräglad'	No
Lemma='könsuppdelad'	No
Lemma='laddad'	Past
Lemma='lagrad'	Past
Lemma='lagstadgad'	No
Lemma='lagstiftande'	Pres
Lemma='lambala-talande'	No
Lemma='lamslagen'	Past
Lemma='landande'	Pres
Lemma='landsomfattande'	No
Lemma='ledande'	Pres
Lemma='ledd'	Past
Lemma='ledsen'	No
Lemma='leende'	Pres
Lemma='legaliserad'	Past
Lemma='lekande'	Pres
Lemma='levande'	Pres
Lemma='levnadsglad'	No
Lemma='likartad'	No
Lemma='liknande'	Pres
Lemma='liten'	No
Lemma='livegen'	No
Lemma='livsmedelsrelaterad'	No
Lemma='lockande'	Pres
Lemma='lokalanställd'	No
Lemma='lokaliserad'	Past
Lemma='lottad'	Past
Lemma='lovande'	Pres
Lemma='luftfylld'	No
Lemma='luggsliten'	No
Lemma='luggsliten'	No
Lemma='lugnande'	Pres
Lemma='lungtilltäppande'	No
Lemma='lurad'	Past
Lemma='lurande'	Pres
Lemma='lutande'	Pres
Lemma='lyckad'	Past
Lemma='lyftad'	No
Lemma='lysande'	Pres
Lemma='läckande'	Pres
Lemma='läderartad'	No
Lemma='lämpad'	Past
Lemma='lättmanövrerad'	No
Lemma='lättstädad'	No
Lemma='lättvättad'	No
Lemma='lågavlönad'	No
Lemma='långtgående'	No
Lemma='låst'	Past
Lemma='lökformad'	No
Lemma='löst'	Past
Lemma='magasinerad'	Past
Lemma='maktutövande'	No
Lemma='malplacerad'	No
Lemma='mantalsskriven'	Past
Lemma='markbaserad'	No
Lemma='markerad'	Past
Lemma='maskstungen'	No
Lemma='massakrerad'	Past
Lemma='medfaren'	No
Lemma='medkännande'	No
Lemma='medlemssökande'	No
Lemma='medsvuren'	No
Lemma='medveten'	No
Lemma='medveten'	No
Lemma='menad'	Past
Lemma='miljonomslutande'	No
Lemma='miljöbestämd'	No
Lemma='minskad'	Past
Lemma='misshandlad'	Past
Lemma='misslyckad'	Past
Lemma='misstänkt'	Past
Lemma='mjukhjärtad'	No
Lemma='mogen'	No
Lemma='moraliserande'	Pres
Lemma='motbjudande'	No
Lemma='motsatt'	No
Lemma='motsvarande'	Pres
Lemma='mottagande'	Pres
Lemma='mulen'	No
Lemma='mullrande'	Pres
Lemma='mumifierad'	Past
Lemma='mumlande'	Pres
Lemma='murad'	Past
Lemma='mycken'	No
Lemma='mädd'	No	mätt
Lemma='märkt'	Past
Lemma='målad'	Past
Lemma='målmedveten'	No
Lemma='mångbesjungen'	No
Lemma='mången'	No
Lemma='mångfacetterad'	No
Lemma='möblerad'	Past
Lemma='mönstergivande'	No
Lemma='mötande'	Pres
Lemma='naken'	No
Lemma='namnändrad'	No
Lemma='nationsskapande'	No
Lemma='nattvagabonderande'	No
Lemma='naturtrogen'	No
Lemma='naturvuxen'	No
Lemma='nedanstående'	No
Lemma='nedbromsad'	No
Lemma='neddammad'	No
Lemma='nedgrävd'	No
Lemma='nedsatt'	Past
Lemma='nedsliten'	No
Lemma='nedslående'	No
Lemma='nedsättande'	Pres
Lemma='nedvänd'	No
Lemma='nedvärderad'	Past
Lemma='nedärvd'	No
Lemma='ner-vänd'	No
Lemma='nerlusad'	No
Lemma='nersjaskad'	No
Lemma='nickande'	Pres
Lemma='norrgående'	No
Lemma='noterad'	Past
Lemma='numrerad'	Past
Lemma='nuvarande'	Pres
Lemma='nyanserad'	Past
Lemma='nyblankad'	No
Lemma='nybliven'	No
Lemma='nybyggd'	No
Lemma='nyemanciperad'	No
Lemma='nyexaminerad'	No
Lemma='nyexploaterad'	No
Lemma='nyfiken'	No
Lemma='nyfödd'	No
Lemma='nygift'	No
Lemma='nyhetsmedveten'	No
Lemma='nyodlad'	No
Lemma='nyproducerad'	No
Lemma='nytillkommen'	No
Lemma='nyttiggjord'	Past
Lemma='nämnd'	Past
Lemma='närbelägen'	No
Lemma='närliggande'	No
Lemma='närstående'	No
Lemma='närvarande'	Pres
Lemma='nästkommande'	No
Lemma='nödställd'	No
Lemma='nöjd'	No
Lemma='oavbruten'	No
Lemma='oavlönad'	No
Lemma='oavslutad'	No
Lemma='obeaktad'	No
Lemma='obebyggd'	No
Lemma='obefläckad'	No
Lemma='obegränsad'	No
Lemma='obegränsad'	No
Lemma='oberoende'	No
Lemma='obeskuren'	No
Lemma='obetald'	No
Lemma='obevakad'	No
Lemma='obeväpnad'	No
Lemma='obildad'	No
Lemma='oblandad'	No
Lemma='obunden'	No
Lemma='odlad'	Past
Lemma='oerfaren'	No
Lemma='oformaterad'	No
Lemma='oförmögen'	No
Lemma='oförändrad'	No
Lemma='ohämmad'	No
Lemma='oinspelad'	No
Lemma='ointresserad'	No
Lemma='oinvigd'	No
Lemma='okokt'	No
Lemma='okomplicerad'	No
Lemma='okonstlad'	No
Lemma='okvalificerad'	No
Lemma='olikartad'	No
Lemma='oljedriven'	No
Lemma='olycksbådande'	No
Lemma='ombonad'	No
Lemma='omdiskuterad'	No
Lemma='omedveten'	No
Lemma='omfattad'	Past
Lemma='omfattande'	Pres
Lemma='omgivande'	Pres
Lemma='omkringliggande'	No
Lemma='ompysslad'	No
Lemma='omsatt'	Past
Lemma='omtalad'	Past
Lemma='omtumlande'	No
Lemma='omtvistad'	No
Lemma='omvänd'	Past
Lemma='omyndigförklarad'	Past
Lemma='oplanerad'	No
Lemma='orakad'	No
Lemma='orangefärgad'	No
Lemma='ordnad'	Past
Lemma='oregelbunden'	No
Lemma='organiserad'	Past
Lemma='oroad'	Past
Lemma='oroande'	Pres
Lemma='oroväckande'	No
Lemma='orubbad'	No
Lemma='oscarsvinnande'	No
Lemma='oskiftad'	No
Lemma='oskyddad'	No
Lemma='osminkad'	No
Lemma='osmält'	No
Lemma='osäkrad'	Past
Lemma='otillfredsställande'	No
Lemma='otillåten'	No
Lemma='otränad'	No
Lemma='oupptäckt'	No
Lemma='outnyttjad'	No
Lemma='outvecklad'	No
Lemma='ovikt'	No
Lemma='ovälkommen'	No
Lemma='oväntad'	No
Lemma='oönskad'	No
Lemma='packad'	Past
Lemma='palatsliknande'	No
Lemma='passerad'	Past
Lemma='passerande'	Pres
Lemma='pensionsberättigad'	No
Lemma='pensionsgrundande'	No
Lemma='personlighetsinriktad'	No
Lemma='pikad'	No
Lemma='pipande'	Pres
Lemma='placerad'	Past
Lemma='planerad'	Past
Lemma='planktonätande'	No
Lemma='plattformsoberoende'	No
Lemma='plattfotad'	No
Lemma='porterfärgad'	No
Lemma='poströstande'	No
Lemma='praktiserande'	Pres
Lemma='pressad'	Past
Lemma='prickad'	Past
Lemma='prisvinnande'	No
Lemma='privatpraktiserande'	No
Lemma='privatägd'	No
Lemma='privilegierad'	No
Lemma='processtyrd'	No
Lemma='prunkande'	Pres
Lemma='publicerad'	Past
Lemma='pulveriserad'	Past
Lemma='putsad'	Past
Lemma='pytteliten'	No
Lemma='påbjuden'	Past
Lemma='påfallande'	No
Lemma='påfrestande'	No
Lemma='pågående'	Pres
Lemma='påkommen'	No
Lemma='påstådd'	Past
Lemma='påtvingad'	Past
Lemma='rasande'	Pres
Lemma='realitetsanpassad'	No
Lemma='redovisad'	Past
Lemma='regelbunden'	No
Lemma='regerad'	Past
Lemma='regerande'	Pres
Lemma='regisserad'	Past
Lemma='reglerad'	Past
Lemma='relaterad'	Past
Lemma='ren'	No
Lemma='rengjord'	Past
Lemma='renodlad'	Past
Lemma='renskurad'	Past
Lemma='rentvättad'	Past
Lemma='representerad'	Past
Lemma='reserverad'	Past
Lemma='respiratorbunden'	No
Lemma='rest'	Past
Lemma='resterande'	Pres
Lemma='riskfylld'	No
Lemma='road'	Past
Lemma='rogivande'	No
Lemma='rollbunden'	No
Lemma='rosafärgad'	No
Lemma='rustad'	Past
Lemma='ruttnande'	Pres
Lemma='ruvande'	Pres
Lemma='rymmande'	Pres
Lemma='räknad'	Past
Lemma='rättrogen'	No
Lemma='rådande'	Pres
Lemma='rådfrågad'	Past
Lemma='rörd'	Past
Lemma='röstande'	Pres
Lemma='röstberättigad'	No
Lemma='röstningsregistrerad'	No
Lemma='sabeltandad'	No
Lemma='sagd'	Past
Lemma='samhällsbildande'	No
Lemma='samlad'	Past
Lemma='sammanboende'	Pres
Lemma='sammanfattad'	Past
Lemma='sammanfattande'	Pres
Lemma='sammanflätad'	Past
Lemma='sammanfogad'	Past
Lemma='sammanförd'	Past
Lemma='sammanhållande'	Pres
Lemma='sammankopplande'	Pres
Lemma='sammanlagd'	Past
Lemma='sammansatt'	Past
Lemma='sammetsdraperad'	No
Lemma='samordnad'	Past
Lemma='sargande'	Pres
Lemma='schizofren'	No
Lemma='sedd'	Past
Lemma='seglivad'	No
Lemma='sekulariserad'	Past
Lemma='sen'	No
Lemma='servicebetonad'	No
Lemma='sexualstimulerande'	No
Lemma='silverbågad'	No
Lemma='silverglänsande'	No
Lemma='silverskimrande'	No
Lemma='sintrad'	Past
Lemma='sistnämnd'	No
Lemma='sittande'	Pres
Lemma='sjukfrånvarande'	No
Lemma='sjukpenningförsäkrad'	No
Lemma='sjunkande'	Pres
Lemma='självbelåten'	No
Lemma='självblandande'	No
Lemma='självdeklarerad'	No
Lemma='självförsörjande'	No
Lemma='självlysande'	No
Lemma='självreglerande'	No
Lemma='självstyrande'	No
Lemma='sjögående'	No
Lemma='skadad'	Past
Lemma='skaftad'	Past
Lemma='skalad'	Past
Lemma='skalkokt'	No
Lemma='skapad'	Past
Lemma='skapande'	Pres
Lemma='skarpladdad'	No
Lemma='skattad'	Past
Lemma='skiftande'	Pres
Lemma='skild'	Past
Lemma='skinande'	Pres
Lemma='skjutberedd'	No
Lemma='skjuten'	Past
Lemma='skrikande'	Pres
Lemma='skriven'	Past
Lemma='skrivskyddad'	No
Lemma='skrumpnad'	Past
Lemma='skrymmande'	Pres
Lemma='skrynklad'	Past
Lemma='skräckslagen'	No
Lemma='skräddarsydd'	Past
Lemma='skrällande'	Pres
Lemma='skrämmande'	Pres
Lemma='skuldmedveten'	No
Lemma='skulpturliknande'	No
Lemma='skyddad'	Past
Lemma='skyddande'	Pres
Lemma='skymtande'	Pres
Lemma='skärrad'	Past
Lemma='skött'	Past
Lemma='slingrande'	Pres
Lemma='sliten'	Past
Lemma='slokande'	Pres
Lemma='slopad'	Past
Lemma='slopad'	Past
Lemma='sluten'	Past
Lemma='slutförd'	Past
Lemma='sluttande'	Pres
Lemma='smord'	Past
Lemma='smygande'	Pres
Lemma='smältande'	Pres
Lemma='smärtstillande'	No
Lemma='snabbväxande'	No
Lemma='snedvriden'	Past
Lemma='snubblande'	Pres
Lemma='socialvårdande'	No
Lemma='sorgsen'	No
Lemma='sorlande'	Pres
Lemma='sovande'	Pres
Lemma='sparad'	Past
Lemma='specialiserad'	Past
Lemma='specificerad'	Past
Lemma='spelad'	Past
Lemma='splittrad'	Past
Lemma='splittrad'	Past
Lemma='spridd'	Past
Lemma='springande'	Pres
Lemma='spänd'	Past
Lemma='spännande'	No
Lemma='spärrad'	Past
Lemma='stabiliserad'	Past
Lemma='stadfäst'	Past
Lemma='stadigvarande'	No
Lemma='standardbaserad'	No
Lemma='standardiserad'	Past
Lemma='statsanställd'	No
Lemma='stegrad'	Past
Lemma='stenkolsdriven'	No
Lemma='stickande'	Pres
Lemma='stiftad'	Past
Lemma='stigande'	Pres
Lemma='stiliserad'	Past
Lemma='stillasittande'	No
Lemma='stillastående'	No
Lemma='stimulerad'	Past
Lemma='stimulerande'	Pres
Lemma='stinkande'	Pres
Lemma='stirrande'	Pres
Lemma='storleksminskad'	No
Lemma='streckad'	Past
Lemma='stressad'	Past
Lemma='stressande'	Pres
Lemma='stridande'	Pres
Lemma='stridslysten'	No
Lemma='strukturomdanande'	No
Lemma='strålande'	Pres
Lemma='strömmande'	Pres
Lemma='studerande'	Pres
Lemma='stympad'	Past
Lemma='stämd'	Past
Lemma='stödgivande'	No
Lemma='störande'	Pres
Lemma='störd'	Past
Lemma='svepande'	Pres
Lemma='svettglänsande'	No
Lemma='sviktande'	Pres
Lemma='svindlande'	Pres
Lemma='svältande'	Pres
Lemma='svävande'	Pres
Lemma='svårbehandlad'	No
Lemma='svårtolkad'	No
Lemma='synskadad'	No
Lemma='sysselsatt'	Past
Lemma='säkerställd'	Past
Lemma='säljande'	Pres
Lemma='sänkt'	Past
Lemma='särpräglad'	Past
Lemma='särskild'	Past
Lemma='så_kallad'	No
Lemma='såld'	Past
Lemma='såld'	Past
Lemma='sårad'	Past
Lemma='södergående'	No
Lemma='sökande'	Pres
Lemma='sönderriven'	No
Lemma='sönderslagen'	No
Lemma='sörjande'	Pres
Lemma='tabuladdad'	No
Lemma='tagen'	Past
Lemma='talad'	Past
Lemma='talande'	Pres
Lemma='taxerad'	Past
Lemma='tecknad'	Past
Lemma='tempererad'	Past
Lemma='termogenererad'	No
Lemma='tidskrävande'	No
Lemma='tillbakadragen'	No
Lemma='tilldragande'	Pres
Lemma='tillfredsställande'	Pres
Lemma='tillfredsställd'	Past
Lemma='tillförd'	Past
Lemma='tillgiven'	No
Lemma='tillhörande'	Pres
Lemma='tilltalande'	Pres
Lemma='tillåten'	Past
Lemma='timavlönad'	No
Lemma='topprustad'	No
Lemma='toppseedad'	No
Lemma='topputrustad'	No
Lemma='torkad'	Past
Lemma='totalutrustad'	No
Lemma='travad'	Past
Lemma='tredjepartstillverkad'	No
Lemma='troende'	Pres
Lemma='trogen'	No
Lemma='trädkantad'	No
Lemma='trögflytande'	No
Lemma='tvingad'	Past
Lemma='tvungen'	Past
Lemma='typsatt'	Past
Lemma='typtrogen'	No
Lemma='tystlåten'	No
Lemma='täckt'	Past
Lemma='tändande'	Pres
Lemma='tänkande'	Pres
Lemma='tänkt'	Past
Lemma='tättbebodd'	No
Lemma='tättbefolkad'	No
Lemma='undanforslad'	No
Lemma='undantagen'	Past
Lemma='underbeskyddad'	No
Lemma='underförstådd'	Past
Lemma='underkastad'	Past
Lemma='underliggande'	No
Lemma='underlägsen'	No
Lemma='underordnad'	Past
Lemma='underskriven'	Past
Lemma='undersökt'	Past
Lemma='underutvecklad'	No
Lemma='undervisande'	Pres
Lemma='undrande'	Pres
Lemma='undvikande'	Pres
Lemma='unken'	No
Lemma='uppassad'	No
Lemma='uppbyggd'	Past
Lemma='uppdelad'	Past
Lemma='uppdragen'	Past
Lemma='uppfostrande'	Pres
Lemma='uppfriskande'	Pres
Lemma='upphetsad'	Past
Lemma='upphetsande'	Pres
Lemma='upphettad'	Past
Lemma='uppiggande'	No
Lemma='uppjagande'	No
Lemma='upplevd'	Past
Lemma='upplysande'	Pres
Lemma='upplösande'	Pres
Lemma='uppmuntrande'	Pres
Lemma='uppnådd'	Past
Lemma='uppoffrande'	Pres
Lemma='upprepad'	Past
Lemma='upprivande'	No
Lemma='upprättad'	Past
Lemma='upprörande'	Pres
Lemma='uppsagd'	Past
Lemma='uppsamlad'	Past
Lemma='uppskattad'	Past
Lemma='uppskattande'	Pres
Lemma='uppskjuten'	Past
Lemma='uppslagen'	No
Lemma='uppslammad'	No
Lemma='uppslitsad'	No
Lemma='uppsluppen'	No
Lemma='uppspärrad'	No
Lemma='uppställd'	Past
Lemma='upptagen'	Past
Lemma='uppvaknad'	Past
Lemma='uppviglande'	Pres
Lemma='uppvärderad'	Past
Lemma='uppväxande'	No
Lemma='uppåtböjd'	No
Lemma='uppåtsipprande'	No
Lemma='utarbetad'	Past
Lemma='utbildad'	Past
Lemma='utbildande'	Pres
Lemma='utbredd'	Past
Lemma='utbudsstimulerande'	No
Lemma='utbyggd'	Past
Lemma='utdragen'	No
Lemma='utebliven'	Past
Lemma='utestängd'	Past
Lemma='utformad'	Past
Lemma='utförd'	Past
Lemma='utgiven'	Past
Lemma='utgående'	Pres
Lemma='utkastliknande'	No
Lemma='utkörd'	No
Lemma='utlämnad'	Past
Lemma='utmanande'	Pres
Lemma='utmattad'	Past
Lemma='utmärkande'	Pres
Lemma='utmärkt'	Past
Lemma='utnyttjad'	Past
Lemma='utomstående'	No
Lemma='utplånad'	Past
Lemma='utpräglad'	No
Lemma='utredande'	Pres
Lemma='utrullad'	No
Lemma='utrustad'	Past
Lemma='utrymmeskrävande'	No
Lemma='uträknad'	No
Lemma='utsagd'	Past
Lemma='utsatt'	Past
Lemma='utsedd'	Past
Lemma='utsirad'	Past
Lemma='utslungad'	Past
Lemma='utsparad'	No
Lemma='utspänd'	No
Lemma='utspärrad'	Past
Lemma='utstuderad'	No
Lemma='utstående'	Pres
Lemma='utsugen'	Past
Lemma='utsvulten'	No
Lemma='uttagen'	No
Lemma='uttalad'	Past
Lemma='uttryckt'	Past
Lemma='utträngd'	No
Lemma='utvald'	Past
Lemma='utvecklad'	Past
Lemma='utvidgad'	Past
Lemma='utåtriktad'	No
Lemma='utökad'	Past
Lemma='vaccinerad'	Past
Lemma='vaken'	No
Lemma='vald'	Past
Lemma='vandrande'	Pres
Lemma='vanebildande'	No
Lemma='varierande'	Pres
Lemma='varnande'	Pres
Lemma='vattengenererad'	No
Lemma='vederkvickande'	Pres
Lemma='verkande'	Pres
Lemma='verklighetsfrämmande'	No
Lemma='verkställande'	Pres
Lemma='vibrerande'	Pres
Lemma='vidbrättad'	No
Lemma='vidgad'	Past
Lemma='vidstående'	No
Lemma='vidtalad'	Past
Lemma='vikarierande'	Pres
Lemma='vilsekommen'	No
Lemma='vindlande'	Pres
Lemma='vinkande'	Pres
Lemma='virvlande'	Pres
Lemma='visad'	Past
Lemma='visslande'	Pres
Lemma='vitblänkande'	No
Lemma='vittgående'	No
Lemma='vittrande'	Pres
Lemma='voltande'	Pres
Lemma='vunnen'	Past
Lemma='vuxen'	No
Lemma='vägledande'	Pres
Lemma='välanpassad'	No
Lemma='välbalanserad'	No
Lemma='välbelägen'	No
Lemma='välborstad'	No
Lemma='välbärgad'	No
Lemma='välformad'	No
Lemma='välfostrad'	No
Lemma='välfärdshöjande'	No
Lemma='välgrundad'	No
Lemma='välgörande'	No
Lemma='välinformerad'	No
Lemma='välintegrerad'	No
Lemma='välkommen'	No
Lemma='välkvalificerad'	No
Lemma='välkänd'	No
Lemma='välmenande'	No
Lemma='välmeriterad'	No
Lemma='välplanerad'	No
Lemma='välsignad'	No
Lemma='välskött'	No
Lemma='väntad'	Past
Lemma='väntande'	Pres
Lemma='värderad'	Past
Lemma='värdeskyddad'	No
Lemma='värkande'	Pres
Lemma='världsberömd'	No
Lemma='väsande'	Pres
Lemma='växande'	Pres
Lemma='växlande'	Pres
Lemma='växtsaftsliknande'	No
Lemma='vårdad'	Past
Lemma='vårdande'	Pres
Lemma='xml-baserad'	No
Lemma='xml-definierad'	No
Lemma='xml-liknande'	No
Lemma='xml-relaterad'	No
Lemma='yrkesutövande'	No
Lemma='ägd'	Past
Lemma='ägnad'	Past
Lemma='älskad'	Past
Lemma='ändrad'	Past
Lemma='ärad'	Past
Lemma='ärelysten'	No
Lemma='åder-framhävande'	No
Lemma='åldersblandad'	No
Lemma='ålderstigen'	No
Lemma='åldrad'	Past
Lemma='ångestskapande'	No
Lemma='ånggenererad'	No
Lemma='årstidsbunden'	No
Lemma='återkommande'	Pres
Lemma='återställd'	Past
Lemma='återstående'	Pres
Lemma='åtföljande'	Pres
Lemma='åtskild'	Past
Lemma='ödesbetonad'	No
Lemma='ökad'	Past
Lemma='ökande'	Pres
Lemma='önskad'	Past
Lemma='öppen'	No
Lemma='öronbedövande'	No
Lemma='överarbetande'	Pres
Lemma='överbeskyddad'	Past
Lemma='överbliven'	No
Lemma='överdimensionerad'	Past
Lemma='överdriven'	Past
Lemma='överenskommen'	Past
Lemma='övergripande'	No
Lemma='övergående'	Pres
Lemma='överlägsen'	No
Lemma='överlämnad'	Past
Lemma='övermekaniserad'	No
Lemma='överprivilegierad'	No
Lemma='överraskad'	Past
Lemma='överraskande'	Pres
Lemma='överreglerande'	No
Lemma='översatt'	Past
Lemma='överseende'	Pres
Lemma='överstigande'	Pres
Lemma='överstånden'	No
Lemma='översänd'	Past
Lemma='överträffande'	Pres
Lemma='övertygad'	Past
Lemma='övervägande'	Pres
Lemma='övervägd'	Past
Lemma='sönderklippt'	Past
Lemma='smörstekt'	Past
Lemma='stärkt'	Past
Lemma='förtjust'	Past
Lemma='nött'	Past
Lemma='upplagd'	No
Lemma='opåverkad'	No
Lemma='fjärrundersökt'	No
Lemma='hörselskadad'	No
Lemma='vänd'	Past
Lemma='tvättad'	Past
Lemma='tillgodosedd'	Past
Lemma='förstärkt'	Past
Lemma='uppropad'	No
Lemma='matroniserad'	No
Lemma='insatt'	Past
Lemma='likställd'	Past
Lemma='undandragen'	Past
Lemma='lämnad'	Past
Lemma='omhändertagen'	Past
Lemma='lastad'	Past
Lemma='spräckt'	Past
Lemma='föreställd'	Past
Lemma='hopkrupen'	No
Lemma='förlamad'	Past
Lemma='inlåst'	No
Lemma='iförd'	Past
Lemma='förborgad'	Past
Lemma='uppäten'	No
Lemma='påverkad'	Past
Lemma='invalidiserad'	Past
Lemma='bedövad'	Past
Lemma='emanciperad'	Past
Lemma='diciplinerad'	Past
Lemma='frusterad'	Past
Lemma='stammande'	Pres
Lemma='liggande'	Pres
Lemma='förhörd'	Past
Lemma='bjuden'	Past
Lemma='omkramad'	No
Lemma='åtlydd'	Past
Lemma='behandlad'	Past
Lemma='åtrådd'	Past