form='stadda'	lemma='städja'	feats='Case=Nom|Degree=Pos|Number=Plur'	treebank='talbanken'
form='stadda'	lemma='stadd'	feats='Case=Nom|Definite=Ind|Degree=Pos|Number=Plur'	treebank='lines_dev'
form='blandade'	lemma='blanda'	feats='Case=Nom|Definite=Def|Degree=Pos|Number=Sing'	treebank='lines_dev'
form='blandat'	lemma='blanda'	feats='Case=Nom|Definite=Ind|Degree=Pos|Number=Sing'	treebank='lines_dev'
form='ansedda'	lemma='anse'	feats='Case=Nom|Definite=Def'	treebank='lines_test'
form='baldakinförsedda'	lemma='baldakinförsedd'	feats='Case=Nom|Definite=Def|Degree=Pos|Gender=Com|Number=Sing'	treebank='lines_test'
form='spridda'	lemma='spridd'	feats='Case=Nom|Degree=Pos|Number=Plur'	treebank='pud'
form='spridda'	lemma='spridd'	feats='Case=Nom|Definite=Ind|Degree=Pos|Number=Plur'	treebank='talbanken'
form='kringspridda'	lemma='kringspridd'	feats='Case=Nom|Definite=Ind|Degree=Pos|Number=Plur'	treebank='lines_dev'
form='kringspridda'	lemma='kringspridd'	feats='Case=Nom|Definite=Ind|Degree=Pos|Number=Plur'	treebank='lines_test'
form='tättbebodda'	lemma='tättbebodd'	feats='Case=Nom|Definite=Ind|Degree=Pos|Number=Plur'	treebank='talbanken'
form='rödklädda'	lemma='rödklädd'	feats='Case=Nom|Definite=Def|Degree=Pos|Gender=Com|Number=Sing'	treebank='lines_test'
form='skogklädda'	lemma='skogklädd'	feats='Case=Nom|Definite=Def|Degree=Pos|Number=Plur'	treebank='lines_test'
form='svartklädda'	lemma='svartklädd'	feats='Case=Nom|Definite=Ind|Degree=Pos|Number=Plur'	treebank='lines_test'
form='halvklädda'	lemma='halvklädd'	feats='Case=Nom|Definite=Ind|Degree=Pos|Number=Plur'	treebank='lines_test'
form='födda'	lemma='född'	feats='Case=Nom|Definite=Ind|Degree=Pos|Number=Plur'	treebank='talbanken'
form='ofödda'	lemma='ofödd'	feats='Case=Nom|Degree=Pos|Number=Plur'	treebank='pud'
form='nyfödda'	lemma='nyfödd'	feats='Case=Nom|Definite=Ind|Degree=Pos|Number=Plur'	treebank='talbanken'
form='bakbundna'	lemma='bakbunden'	feats='Case=Nom|Definite=Ind|Degree=Pos|Number=Plur'	treebank='lines_test'
form='regelbundna'	lemma='regelbunden'	feats='Case=Nom|Definite=Ind|Degree=Pos|Number=Plur'	treebank='lines_test'
form='oregelbundna'	lemma='oregelbunden'	feats='Case=Nom|Degree=Pos|Number=Plur'	treebank='talbanken'
form='obundna'	lemma='obunden'	feats='Case=Nom|Definite=Ind|Degree=Pos|Number=Plur'	treebank='lines_test'
form='överståndna'	lemma='överstånden'	feats='Case=Nom|Definite=Ind|Degree=Pos|Number=Plur'	treebank='lines_test'
form='sönderslagna'	lemma='sönderslagen'	feats='Case=Nom|Definite=Def|Degree=Pos|Number=Plur'	treebank='lines_test'
form='tillbakadragna'	lemma='tillbakadragen'	feats='Case=Nom|Definite=Ind|Degree=Pos|Number=Plur'	treebank='lines_test'
form='Heldragna'	lemma='heldragen'	feats='Case=Nom|Degree=Pos|Number=Plur'	treebank='talbanken'
form='uppdragna'	lemma='uppdragen'	feats='Case=Nom|Definite=Ind|Number=Plur'	treebank='lines_test'
form='utdragna'	lemma='utdragen'	feats='Case=Nom|Definite=Def|Degree=Pos|Number=Plur'	treebank='lines_test'
orm='mångbesjungna'	lemma='mångbesjungen'	feats='Case=Nom|Definite=Def|Degree=Pos|Number=Plur'	treebank='lines_test'
form='maskstungna'	lemma='maskstungen'	feats='Case=Nom|Definite=Ind|Degree=Pos|Number=Plur'	treebank='lines_test'
form='gångna'	lemma='gå'	feats='Case=Nom|Definite=Def|Degree=Pos|Gender=Com|Number=Sing'	treebank='lines_test'
form='gångna'	lemma='gå'	feats='Case=Nom|Definite=Def|Degree=Pos|Number=Plur'	treebank='lines_test'
form='förtrogna'	lemma='förtrogen'	feats='Case=Nom|Definite=Def|Degree=Pos|Gender=Com|Number=Sing'	treebank='lines_test'
?form='rättrogna'	lemma='rättrogen'	feats='Case=Nom|Definite=Def|Degree=Pos|Number=Plur'	treebank='lines_test'
form='insjunkna'	lemma='insjunken'	feats='Case=Nom|Definite=Def|Degree=Pos|Number=Plur'	treebank='lines_dev'
form='insjunkna'	lemma='insjunken'	feats='Case=Nom|Definite=Ind|Degree=Pos|Number=Plur'	treebank='lines_dev'
form='fallna'	lemma='fallen'	feats='Case=Nom|Definite=Ind|Degree=Pos|Number=Plur'	treebank='lines_test'
form='bortkomna'	lemma='bortkommen'	feats='Case=Nom|Definite=Ind|Degree=Pos|Number=Plur'	treebank='lines_dev'
form='medfarna'	lemma='medfarna'	feats='Case=Nom|Definite=Ind|Degree=Pos|Number=Plur'	treebank='lines_test'
form='finskurna'	lemma='finskuren'	feats='Case=Nom|Definite=Ind|Degree=Pos|Number=Plur'	treebank='lines_test'
form='frusna'	lemma='frusen'	feats='Case=Nom|Definite=Ind|Degree=Pos|Number=Plur'	treebank='lines_test'
?form='luggslitna'	lemma='luggsliten'	feats='Case=Nom|Definite=Ind|Degree=Pos|Number=Plur'	treebank='lines_test'
form='helgjutna'	lemma='helgjuten'	feats='Case=Nom|Definite=Def|Degree=Pos'	treebank='lines_test'
form='slutna'	lemma='sluten'	feats='Case=Nom|Definite=Ind|Degree=Pos|Number=Plur'	treebank='lines_test'
form='tillåtna'	lemma='tillåten'	feats='Case=Nom|Definite=Ind|Degree=Pos|Number=Plur'	treebank='lines_test'
form='givna'	lemma='given'	feats='Case=Nom|Definite=Ind|Degree=Pos|Number=Plur'	treebank='lines_test'
form='tillgivna'	lemma='tillgiven'	feats='Case=Nom|Definite=Def|Degree=Pos|Number=Sing'	treebank='talbanken'
form='övergivna'	lemma='överge'	feats='Case=Nom|Definite=Def|Degree=Pos|Gender=Com|Number=Sing'	treebank='lines_test'
form='gudsgivna'	lemma='gudsgiven'	feats='Case=Nom|Definite=Def|Degree=Pos|Number=Sing'	treebank='pud'
form='utgivna'	lemma='utgiven'	feats='Case=Nom|Definite=Ind|Degree=Pos|Number=Plur'	treebank='lines_test'
form='överblivna'	lemma='överbliven'	feats='Case=Nom|Definite=Def|Degree=Pos|Gender=Com|Number=Sing'	treebank='lines_test'
form='nyblivna'	lemma='nybliven'	feats='Case=Nom|Degree=Pos|Number=Plur'	treebank='talbanken'
form='nyblivna'	lemma='nybliven'	feats='Case=Nom|Definite=Def|Degree=Pos|Number=Sing'	treebank='talbanken'
form='överdrivna'	lemma='överdriven'	feats='Case=Nom|Definite=Ind|Degree=Pos|Number=Plur'	treebank='lines_test'
form='överdrivna'	lemma='överdriven'	feats='Case=Nom|Degree=Pos|Number=Plur'	treebank='pud'
form='sönderrivna'	lemma='sönderriven'	feats='Case=Nom|Definite=Ind|Degree=Pos|Number=Plur'	treebank='lines_test'
form='vuxna'	lemma='vuxen'	feats='Case=Nom|Degree=Pos|Number=Plur'	treebank='pud'
form='vuxna'	lemma='vuxen'	feats='Case=Nom|Definite=Def|Degree=Pos|Number=Sing'	treebank='talbanken'
form='vuxna'	lemma='vuxen'	feats='Case=Nom|Degree=Pos|Number=Plur'	treebank='talbanken'
form='naturvuxna'	lemma='naturvuxen'	feats='Case=Nom|Definite=Def|Degree=Pos|Number=Sing'	treebank='talbanken'
form='halvvuxna'	lemma='halvvuxen'	feats='Case=Nom|Degree=Pos|Number=Plur'	treebank='talbanken'
form='djävulsbesatta'	lemma='djävulsbesatt'	feats='Case=Nom|Definite=Def|Degree=Pos|Number=Plur'	treebank='lines_dev'
form='sammansatta'	lemma='sammansatt'	feats='Case=Nom|Definite=Def|Degree=Pos'	treebank='talbanken'
form='bosatta'	lemma='bosatt'	feats='Case=Nom|Definite=Ind|Degree=Pos|Number=Plur'	treebank='talbanken'
form='motsatta'	lemma='motsatt'	feats='Case=Nom|Definite=Def|Degree=Pos'	treebank='talbanken'
form='motsatta'	lemma='motsatt'	feats='Case=Nom|Definite=Ind|Degree=Pos|Number=Plur'	treebank='talbanken'
form='mätta'	lemma='mätt'	feats='Case=Nom|Definite=Ind|Degree=Pos|Number=Plur'	treebank='talbanken'
form='upprätta'	lemma='upprätt'	feats='Case=Nom|Degree=Pos|Number=Plur'	treebank='pud'
form='välskötta'	lemma='välskött'	feats='Case=Nom|Definite=Ind|Degree=Pos|Number=Plur'	treebank='talbanken'
form='uppblötta'	lemma='uppblöta'	feats='Case=Nom|Definite=Ind|Degree=Pos|Number=Plur'	treebank='lines_test'
form='slätnötta'	lemma='slätnött'	feats='Case=Nom|Definite=Def|Degree=Pos|Number=Plur'	treebank='lines_test'
form='halvskyddad'	lemma='halvskyddad'	feats='Case=Nom|Definite=Ind|Degree=Pos|Gender=Com|Number=Sing'	treebank='talbanken'
form='koleldad'	lemma='koleldad'	feats='Case=Nom|Definite=Ind|Degree=Pos|Gender=Com|Number=Sing'	treebank='lines_test'
form='obildad'	lemma='obildad'	feats='Case=Nom|Definite=Ind|Degree=Pos|Gender=Com|Number=Sing'	treebank='lines_test'
form='oblandad'	lemma='oblandad'	feats='Case=Nom|Definite=Ind|Degree=Pos|Gender=Com|Number=Sing'	treebank='lines_test'
form='hopblandad'	lemma='hopblandad'	feats='Case=Nom|Definite=Ind|Degree=Pos|Gender=Com|Number=Sing'	treebank='lines_dev'
form='vårdad'	lemma='vårdad'	feats='Case=Nom|Definite=Ind|Degree=Pos|Gender=Com|Number=Sing'	treebank='lines_test'
form='rosafärgad'	lemma='rosafärgad'	feats='Case=Nom|Definite=Ind|Degree=Pos|Gender=Com|Number=Sing'	treebank='lines_test'
form='övertygad'	lemma='övertygad'	feats='Case=Nom|Definite=Ind|Degree=Pos|Gender=Com|Number=Sing'	treebank='lines_test'
form='orakad'	lemma='orakad'	feats='Case=Nom|Definite=Ind|Degree=Pos|Number=Sing'	treebank='lines_dev'
form='packad'	lemma='packad'	feats='Case=Nom|Definite=Ind|Gender=Com|Number=Sing'	treebank='lines_test'
form='fullpackad'	lemma='fullpackad'	feats='Definite=Ind|Degree=Pos|Gender=Com|Number=Sing'	treebank='lines_test'
form='streckad'	lemma='streckad'	feats='Case=Nom|Definite=Ind|Degree=Pos|Number=Sing'	treebank='lines_dev'
form='prickad'	lemma='prickad'	feats='Case=Nom|Definite=Ind|Degree=Pos|Number=Sing'	treebank='lines_dev'
form='chockad'	lemma='chockad'	feats='Case=Nom|Definite=Ind|Degree=Pos|Gender=Com|Number=Sing'	treebank='lines_test'
form='misslyckad'	lemma='misslyckad'	feats='Case=Nom|Definite=Ind|Degree=Pos|Gender=Com|Number=Sing'	treebank='lines_test'
form='blodfläckad'	lemma='blodfläckad'	feats='Case=Nom|Definite=Ind|Degree=Pos|Gender=Com|Number=Sing'	treebank='lines_test'
form='obefläckad'	lemma='obefläckad'	feats='Case=Nom|Definite=Ind|Degree=Pos|Gender=Com|Number=Sing'	treebank='lines_test'
form='osminkad'	lemma='osminkad'	feats='Case=Nom|Definite=Ind|Degree=Pos|Number=Sing'	treebank='lines_dev'
form='överraskad'	lemma='överraskad'	feats='Case=Nom|Definite=Ind|Degree=Pos|Gender=Com|Number=Sing'	treebank='lines_test'
form='förälskad'	lemma='förälskad'	feats='Case=Nom|Definite=Ind|Degree=Pos|Gender=Com|Number=Sing'	treebank='lines_test'
form='spelad'	lemma='spela'	feats='Case=Nom|Definite=Ind|Degree=Pos|Gender=Com|Number=Sing'	treebank='lines_test'
form='invecklad'	lemma='invecklad'	feats='Case=Nom|Definite=Ind|Degree=Pos|Gender=Com|Number=Sing'	treebank='lines_test'
form='kallad'	lemma='kalla'	feats='Degree=Pos'	treebank='lines_test'
form='Förtrollad'	lemma='förtrollad'	feats='Case=Nom|Definite=Ind|Degree=Pos|Gender=Com|Number=Sing'	treebank='lines_test'
form='utrullad'	lemma='utrulla'	feats='Case=Nom|Definite=Ind|Degree=Pos|Gender=Com|Number=Sing'	treebank='lines_test'
form='förbryllad'	lemma='förbryllad'	feats='Case=Nom|Definite=Ind|Degree=Pos|Gender=Com|Number=Sing'	treebank='lines_test'
form='undanforslad'	lemma='undanforsla'	feats='Case=Nom|Definite=Ind|Degree=Pos|Gender=Com|Number=Sing'	treebank='lines_test'
form='okonstlad'	lemma='okonstlad'	feats='Case=Nom|Definite=Ind|Degree=Pos|Gender=Com|Number=Sing'	treebank='lines_test'
form='Ohämmad'	lemma='ohämmad'	feats='Case=Nom|Definite=Ind|Degree=Pos|Gender=Com|Number=Sing'	treebank='talbanken'
form='ägnad'	lemma='ägnad'	feats='Case=Nom|Definite=Ind|Gender=Com|Number=Sing'	treebank='lines_test'
form='uppvaknad'	lemma='uppvakna'	feats='Case=Nom|Definite=Ind|Degree=Pos|Gender=Com|Number=Sing'	treebank='lines_test'
form='skrumpnad'	lemma='skrumpna'	feats='Case=Nom|Definite=Ind|Degree=Pos|Gender=Com|Number=Sing'	treebank='lines_test'
form='obeväpnad'	lemma='obeväpnad'	feats='Case=Nom|Definite=Ind|Degree=Pos|Gender=Com|Number=Sing'	treebank='pud'
form='grånad'	lemma='grånad'	feats='Case=Nom|Definite=Ind|Gender=Com|Number=Sing'	treebank='lines_test'
form='förvånad'	lemma='förvånad'	feats='Case=Nom|Definite=Ind|Degree=Pos|Number=Sing'	treebank='lines_dev'
form='förvånad'	lemma='förvånad'	feats='Case=Nom|Definite=Ind|Degree=Pos|Gender=Com|Number=Sing'	treebank='lines_test'
form='barskrapad'	lemma='barskrapad'	feats='Case=Nom|Definite=Ind|Degree=Pos|Gender=Com|Number=Sing'	treebank='pud'
form='stympad'	lemma='stympad'	feats='Case=Nom|Definite=Ind|Degree=Pos|Gender=Com|Number=Sing'	treebank='lines_test'
form='dämpad'	lemma='dämpa'	feats='Case=Nom|Definite=Ind|Degree=Pos|Gender=Com|Number=Sing'	treebank='lines_test'
form='fördjupad'	lemma='fördjupa'	feats='Case=Nom|Definite=Ind|Degree=Pos|Gender=Com|Number=Sing'	treebank='lines_test'
form='okvalificerad'	lemma='okvalificerad'	feats='Case=Nom|Definite=Ind|Degree=Pos|Gender=Com|Number=Sing'	treebank='pud'
form='okomplicerad'	lemma='okomplicerad'	feats='Case=Nom|Definite=Ind|Degree=Pos|Gender=Com|Number=Sing'	treebank='lines_test'
form='utstuderad'	lemma='utstuderad'	feats='Case=Nom|Definite=Ind|Degree=Pos|Gender=Com|Number=Sing'	treebank='pud'
form='utstuderad'	lemma='utstuderad'	feats='Case=Nom|Definite=Ind|Degree=Pos|Gender=Com|Number=Sing'	treebank='lines_test'
form='distingerad'	lemma='distingerad'	feats='Case=Nom|Definite=Ind|Degree=Pos|Number=Sing'	treebank='lines_dev'
form='korrugerad'	lemma='korrugerad'	feats='Case=Nom|Definite=Ind|Degree=Pos|Gender=Com|Number=Sing'	treebank='lines_test'
form='definierad'	lemma='definiera'	feats='Case=Nom|Definite=Ind|Degree=Pos|Number=Sing'	treebank='lines_dev'
form='Detaljerad'	lemma='detaljerad'	feats='Case=Nom|Definite=Ind|Degree=Pos|Gender=Com|Number=Sing'	treebank='lines_test'
form='detaljerad'	lemma='detaljerad'	feats='Case=Nom|Definite=Ind|Degree=Pos|Gender=Com|Number=Sing'	treebank='lines_test'
form='markerad'	lemma='markerad'	feats='Case=Nom'	treebank='lines_test'
form='generad'	lemma='generad'	feats='Case=Nom|Definite=Ind|Degree=Pos|Number=Sing'	treebank='lines_test'
form='generad'	lemma='generad'	feats='Case=Nom|Definite=Ind|Degree=Pos|Number=Sing'	treebank='lines_dev'
form='indignerad'	lemma='indignerad'	feats='Case=Nom|Definite=Ind|Degree=Pos|Number=Sing'	treebank='lines_dev'
form='nyexaminerad'	lemma='nyexaminerad'	feats='Case=Nom|Definite=Ind|Degree=Pos|Gender=Com|Number=Sing'	treebank='lines_test'
form='integrerad'	lemma='integrera'	feats='Case=Nom|Definite=Ind|Degree=Pos|Number=Sing'	treebank='lines_dev'
form='Filtrerad'	lemma='filtrera'	feats='Case=Nom|Definite=Ind|Degree=Pos|Gender=Com|Number=Sing'	treebank='lines_test'
form='koncentrerad'	lemma='koncentrerad'	feats='Case=Nom|Definite=Ind|Degree=Pos|Number=Sing'	treebank='lines_dev'
form='civiliserad'	lemma='civiliserad'	feats='Case=Nom|Definite=Ind|Degree=Pos|Gender=Com|Number=Sing'	treebank='lines_test'
form='oformaterad'	lemma='oformaterad'	feats='Case=Nom|Definite=Ind|Degree=Pos|Gender=Com|Number=Sing'	treebank='lines_test'
form='irriterad'	lemma='irriterad'	feats='Case=Nom|Definite=Ind|Degree=Pos|Gender=Com|Number=Sing'	treebank='lines_test'
form='kultiverad'	lemma='kultiverad'	feats='Case=Nom|Definite=Ind|Degree=Pos|Gender=Com|Number=Sing'	treebank='lines_test'
form='reserverad'	lemma='reserverad'	feats='Case=Nom|Definite=Ind|Degree=Pos|Number=Sing'	treebank='lines_dev'
form='reserverad'	lemma='reserverad'	feats='Case=Nom|Definite=Ind|Degree=Pos|Gender=Com|Number=Sing'	treebank='lines_test'
form='utsirad'	lemma='utsirad'	feats='Case=Nom|Definite=Ind|Degree=Pos|Gender=Com|Number=Sing'	treebank='lines_dev'
form='osäkrad'	lemma='osäkrad'	feats='Case=Nom|Definite=Ind|Degree=Pos|Gender=Com|Number=Sing'	treebank='lines_test'
form='förvirrad'	lemma='förvirrad'	feats='Case=Nom|Definite=Ind|Degree=Pos|Number=Sing'	treebank='lines_dev'
form='förvirrad'	lemma='förvirrad'	feats='Case=Nom|Definite=Ind|Degree=Pos|Gender=Com|Number=Sing'	treebank='lines_test'
form='skärrad'	lemma='skärrad'	feats='Case=Nom|Definite=Ind|Degree=Pos|Gender=Com|Number=Sing'	treebank='lines_test'
form='splittrad'	lemma='splittrad'	feats='Case=Nom|Definite=Ind|Degree=Pos|Gender=Com|Number=Sing'	treebank='lines_test'
form='förbättrad'	lemma='förbättra'	feats='Case=Nom|Definite=Ind|Degree=Pos|Gender=Com|Number=Sing'	treebank='lines_test'
form='lurad'	lemma='lurad'	feats='Case=Nom|Definite=Ind|Degree=Pos|Gender=Com|Number=Sing'	treebank='lines_test'
form='murad'	lemma='mura'	feats='Case=Nom|Definite=Ind|Degree=Pos|Gender=Com|Number=Sing'	treebank='lines_test'
form='fårad'	lemma='fårad'	feats='Case=Nom|Definite=Ind|Gender=Com|Number=Sing'	treebank='lines_test'
form='obegränsad'	lemma='obegränsad'	feats='Case=Nom|Definite=Ind|Degree=Pos|Gender=Com|Number=Sing'	treebank='pud'
form='pressad'	lemma='pressa'	feats='Case=Nom|Definite=Ind|Degree=Pos|Number=Sing'	treebank='lines_dev'
form='upphetsad'	lemma='upphetsad'	feats='Case=Nom|Definite=Ind|Gender=Com|Number=Sing'	treebank='lines_test'
form='nerlusad'	lemma='nerlusad'	feats='Case=Nom|Definite=Ind|Degree=Pos|Gender=Com|Number=Sing'	treebank='lines_dev'
form='berusad'	lemma='berusad'	feats='Case=Nom|Definite=Ind|Degree=Pos|Number=Sing'	treebank='lines_test'
form='besläktad'	lemma='besläktad'	feats='Case=Nom|Definite=Ind|Degree=Pos|Gender=Com|Number=Sing'	treebank='talbanken'
form='läderartad'	lemma='läderartad'	feats='Case=Nom|Definite=Ind|Degree=Pos|Number=Sing'	treebank='lines_dev'
form='rustad'	lemma='rustad'	feats='Case=Nom|Definite=Ind|Gender=Com|Number=Sing'	treebank='lines_test'
form='Utmattad'	lemma='utmattad'	feats='Case=Nom|Definite=Ind|Degree=Pos|Number=Sing'	treebank='lines_dev'
form='utmattad'	lemma='utmatta'	feats='Case=Nom|Definite=Ind|Gender=Com|Number=Sing'	treebank='lines_dev'
form='Oavslutad'	lemma='avsluta'	feats='Case=Nom|Definite=Ind|Degree=Pos|Gender=Com|Number=Sing'	treebank='lines_test'
form='fördärvad'	lemma='fördärvad'	feats='Case=Nom|Definite=Ind|Degree=Pos|Gender=Com|Number=Sing'	treebank='lines_test'
form='avskruvad'	lemma='avskruva'	feats='Case=Nom|Definite=Ind|Degree=Pos|Gender=Com|Number=Sing'	treebank='lines_test'
form='skrivberedd'	lemma='skrivberedd'	feats='Case=Nom|Definite=Ind|Degree=Pos|Gender=Com|Number=Sing'	treebank='lines_test'
form='obestridd'	lemma='obestridd'	feats='Case=Nom|Definite=Ind|Degree=Pos|Gender=Com|Number=Sing'	treebank='pud'
form='bebodd'	lemma='bebo'	feats='Case=Nom|Definite=Ind|Degree=Pos|Gender=Com|Number=Sing'	treebank='lines_test'
form='skäggprydd'	lemma='skäggprydd'	feats='Case=Nom|Definite=Ind|Degree=Pos|Gender=Com|Number=Sing'	treebank='lines_test'
form='klädd'	lemma='klädd'	feats='Case=Nom|Definite=Ind|Degree=Pos|Gender=Com|Number=Sing'	treebank='lines_test'
form='uppklädd'	lemma='uppklädd'	feats='Case=Nom|Definite=Ind|Gender=Com|Number=Sing'	treebank='lines_test'
form='övergödd'	lemma='övergöda'	feats='Case=Nom|Definite=Ind|Degree=Pos|Gender=Com|Number=Sing'	treebank='lines_test'
form='förströdd'	lemma='förströdd'	feats='Case=Nom|Definite=Ind|Degree=Pos|Gender=Com|Number=Sing'	treebank='lines_test'
form='Pressurized'	lemma='pressurized'	feats='_'	treebank='talbanken'
form='fetlagd'	lemma='fetlagd'	feats='Case=Nom|Definite=Ind|Degree=Pos|Number=Sing'	treebank='lines_dev'
form='inbyggd'	lemma='inbygga'	feats='Case=Nom|Definite=Ind|Degree=Pos|Gender=Com|Number=Sing'	treebank='lines_test'
form='instängd'	lemma='instängd'	feats='Case=Nom|Definite=Ind|Gender=Com|Number=Sing'	treebank='lines_test'
form='svängd'	lemma='svängd'	feats='Case=Nom|Definite=Ind|Gender=Com|Number=Sing'	treebank='lines_test'
form='framåtböjd'	lemma='framåtböjd'	feats='Mood=Ind|VerbForm=Inf|Voice=Pass'	treebank='lines_test'
form='missnöjd'	lemma='missnöjd'	feats='Case=Nom|Definite=Ind|Degree=Pos|Gender=Com|Number=Sing'	treebank='lines_test'
form='missnöjd'	lemma='missnöjd'	feats='Case=Nom|Definite=Ind|Degree=Pos|Gender=Com|Number=Sing'	treebank='talbanken'
form='enskild'	lemma='enskild'	feats='Case=Nom|Definite=Ind|Degree=Pos|Gender=Com|Number=Sing'	treebank='talbanken'
form='enskild'	lemma='enskild'	feats='Case=Nom|Definite=Ind|Degree=Pos|Number=Sing'	treebank='lines_test'
form='vattenfylld'	lemma='vattenfylld'	feats='Case=Nom|Definite=Ind|Degree=Pos|Gender=Com|Number=Sing'	treebank='lines_test'
form='uppfylld'	lemma='uppfylld'	feats='Case=Nom|Definite=Ind|Degree=Pos|Gender=Com|Number=Sing'	treebank='lines_test'
form='Smärtfylld'	lemma='smärtfylld'	feats='Case=Nom|Definite=Ind|Degree=Pos|Gender=Com|Number=Sing'	treebank='talbanken'
form='inställd'	lemma='inställa'	feats='Case=Nom|Definite=Ind|Degree=Pos|Number=Sing'	treebank='lines_dev'
form='nedstämd'	lemma='nedstämd'	feats='Case=Nom|Definite=Ind|Degree=Pos|Gender=Com|Number=Sing'	treebank='talbanken'
form='obestämd'	lemma='obestämd'	feats='Case=Nom|Definite=Ind|Degree=Pos|Gender=Com|Number=Sing'	treebank='lines_test'
form='bortglömd'	lemma='bortglömd'	feats='Case=Nom|Definite=Ind|Degree=Pos|Gender=Com|Number=Sing'	treebank='lines_test'
form='tömd'	lemma='tömma'	feats='Case=Nom|Definite=Ind|Degree=Pos|Gender=Com|Number=Sing'	treebank='lines_test'
form='känd'	lemma='känd'	feats='Case=Nom|Definite=Ind|Gender=Com|Number=Sing'	treebank='lines_dev'
form='godkänd'	lemma='godkänd'	feats='Case=Nom|Definite=Ind|Degree=Pos|Gender=Com|Number=Sing'	treebank='lines_test'
form='okänd'	lemma='okänd'	feats='Case=Nom|Definite=Ind|Degree=Pos|Gender=Com|Number=Sing'	treebank='lines_dev'
form='okänd'	lemma='okänd'	feats='Case=Nom|Definite=Ind|Degree=Pos|Gender=Com|Number=Sing'	treebank='talbanken'
form='okänd'	lemma='okänd'	feats='Case=Nom|Definite=Ind|Degree=Pos|Number=Sing'	treebank='lines_dev'
form='spänd'	lemma='spänd'	feats='Case=Nom|Definite=Ind|Degree=Pos|Number=Sing'	treebank='lines_dev'
form='gudasänd'	lemma='gudasänd'	feats='Case=Nom|Definite=Ind|Degree=Pos|Number=Sing'	treebank='lines_dev'
form='använd'	lemma='använda'	feats='Case=Nom|Definite=Ind|Degree=Pos|Gender=Com|Number=Sing'	treebank='lines_test'
form='Villkorsstyrd'	lemma='villkorsstyrd'	feats='Case=Nom|Definite=Ind|Degree=Pos|Gender=Com|Number=Sing'	treebank='lines_test'
form='villkorsstyrd'	lemma='villkorsstyrd'	feats='Case=Nom|Definite=Ind|Degree=Pos|Number=Sing'	treebank='lines_dev'
form='lärd'	lemma='lärd'	feats='Case=Nom|Definite=Ind|Degree=Pos|Gender=Com|Number=Sing'	treebank='lines_test'
form='iförd'	lemma='iförd'	feats='Case=Nom|Definite=Ind|Gender=Com|Number=Sing'	treebank='lines_test'
form='oerhörd'	lemma='oerhörd'	feats='Case=Nom|Definite=Ind|Degree=Pos|Gender=Com|Number=Sing'	treebank='talbanken'
form='oberörd'	lemma='oberörd'	feats='Case=Nom|Definite=Ind|Degree=Pos|Number=Sing'	treebank='lines_dev'
form='oberörd'	lemma='oberörd'	feats='Case=Nom|Definite=Ind|Degree=Pos|Gender=Com|Number=Sing'	treebank='lines_test'
form='upprörd'	lemma='upprörd'	feats='Case=Nom|Definite=Ind|Degree=Pos|Number=Sing'	treebank='lines_dev'
form='söndergrävd'	lemma='söndergrävd'	feats='Case=Nom|Definite=Ind|Degree=Pos|Gender=Com|Number=Sing'	treebank='lines_test'
form='död'	lemma='död'	feats='Case=Nom|Definite=Ind|Degree=Pos|Gender=Com|Number=Sing'	treebank='pud'
form='död'	lemma='död'	feats='Case=Nom'	treebank='lines_test'
form='utdöd'	lemma='utdöd'	feats='Case=Nom|Definite=Ind|Degree=Pos|Gender=Com|Number=Sing'	treebank='talbanken'
form='skyddade'	lemma='skydda'	feats='Case=Nom|Definite=Def|Degree=Pos|Number=Sing'	treebank='lines_dev'
form='skyddade'	lemma='skydda'	feats='Case=Nom|Definite=Def|Degree=Pos|Gender=Com|Number=Sing'	treebank='lines_test'
form='blandade'	lemma='blanda'	feats='Case=Nom|Definite=Def|Degree=Pos|Number=Sing'	treebank='lines_dev'
form='inblandade'	lemma='inblandad'	feats='Case=Nom|Definite=Ind|Degree=Pos|Number=Plur'	treebank='lines_test'
form='fulländade'	lemma='fulländad'	feats='Case=Nom|Definite=Def|Degree=Pos|Gender=Com|Number=Sing'	treebank='lines_dev'
form='kortsnaggade'	lemma='kortsnaggad'	feats='Case=Nom|Definite=Def|Degree=Pos|Gender=Neut|Number=Sing'	treebank='lines_test'
form='befullmäktigade'	lemma='befullmäktiga'	feats='Case=Nom|Definite=Def|Degree=Pos|Number=Plur'	treebank='lines_test'
form='utslungade'	lemma='utslunga'	feats='Case=Nom|Definite=Def|Degree=Pos|Gender=Neut|Number=Sing'	treebank='lines_test'
form='orangefärgade'	lemma='orangefärgad'	feats='Case=Nom|Definite=Ind|Degree=Pos|Number=Plur'	treebank='lines_dev'
form='beviljade'	lemma='bevilja'	feats='Case=Nom|Definite=Def|Degree=Pos|Gender=Neut|Number=Sing'	treebank='lines_test'
form='obevakade'	lemma='obevakad'	feats='Case=Nom|Definite=Ind|Degree=Pos|Number=Plur'	treebank='lines_test'
form='chockade'	lemma='chockad'	feats='Case=Nom|Definite=Def|Degree=Pos|Number=Sing'	treebank='lines_dev'
form='lyckade'	lemma='lyckad'	feats='Case=Nom|Definite=Def|Degree=Pos'	treebank='lines_test'
form='lyckade'	lemma='lyckas'	feats='Case=Nom|Definite=Def|Degree=Pos|Number=Plur'	treebank='lines_test'
form='pikade'	lemma='pika'	feats='Case=Nom|Definite=Ind|Degree=Pos|Number=Plur'	treebank='lines_test'
form='nyblankade'	lemma='nyblanka'	feats='Case=Nom|Definite=Ind|Degree=Pos|Number=Plur'	treebank='lines_dev'
form='förälskade'	lemma='förälskad'	feats='Case=Nom|Definite=Ind|Degree=Pos|Number=Plur'	treebank='lines_dev'
form='oönskade'	lemma='oönskad'	feats='Case=Nom|Degree=Pos|Number=Plur'	treebank='pud'
form='behärskade'	lemma='behärska'	feats='Case=Nom|Definite=Def|Degree=Pos|Gender=Neut|Number=Sing'	treebank='lines_test'
form='avtalade'	lemma='avtala'	feats='Case=Nom|Definite=Def|Degree=Pos|Gender=Neut|Number=Sing'	treebank='lines_test'
form='misshandlade'	lemma='misshandla'	feats='Case=Nom|Definite=Ind|Degree=Pos|Number=Plur'	treebank='lines_test'
form='förädlade'	lemma='förädlad'	feats='Case=Nom|Definite=Ind|Degree=Pos|Number=Plur'	treebank='lines_test'
form='förädlade'	lemma='förädlad'	feats='Case=Nom|Definite=Def|Degree=Pos|Gender=Com|Number=Sing'	treebank='lines_test'
form='oinspelade'	lemma='oinspelad'	feats='Case=Nom|Definite=Ind|Degree=Pos|Number=Plur'	treebank='lines_test'
form='avtacklade'	lemma='avtackla'	feats='Case=Nom|Definite=Def|Degree=Pos|Gender=Com|Number=Sing'	treebank='lines_test'
form='invecklade'	lemma='invecklad'	feats='Case=Nom|Definite=Ind|Degree=Pos|Number=Plur'	treebank='lines_test'
form='outvecklade'	lemma='outvecklad'	feats='Case=Nom|Degree=Pos|Number=Plur'	treebank='pud'
form='hycklade'	lemma='hyckla'	feats='Case=Nom|Definite=Def|Degree=Pos|Gender=Com|Number=Sing'	treebank='lines_test'
form='skrynklade'	lemma='skrynkla'	feats='Case=Nom|Definite=Def|Degree=Pos|Number=Plur'	treebank='lines_test'
form='kallade'	lemma='kalla'	feats='Case=Nom|Definite=Def|Degree=Pos'	treebank='lines_test'
form='grillade'	lemma='grilla'	feats='Case=Nom|Definite=Def|Degree=Pos|Gender=Neut|Number=Sing'	treebank='lines_test'
form='inkapslade'	lemma='inkapslad'	feats='Case=Nom|Definite=Ind|Degree=Pos|Number=Plur'	treebank='lines_test'
form='konstlade'	lemma='konstlad'	feats='Case=Nom|Definite=Ind|Number=Plur'	treebank='lines_test'
form='förtvivlade'	lemma='förtvivlad'	feats='Case=Nom|Definite=Ind|Degree=Pos|Number=Plur'	treebank='lines_test'
form='neddammade'	lemma='neddamma'	feats='Case=Nom|Definite=Ind|Degree=Pos|Number=Plur'	treebank='lines_dev'
form='ohämmade'	lemma='ohämmad'	feats='Case=Nom|Definite=Def|Degree=Pos|Gender=Com|Number=Sing'	treebank='lines_test'
form='lökformade'	lemma='lökformad'	feats='Case=Nom|Definite=Ind|Degree=Pos|Gender=Neut|Number=Sing'	treebank='lines_test'
form='lökformade'	lemma='lökformad'	feats='Case=Nom|Definite=Ind|Degree=Pos|Number=Plur'	treebank='lines_test'
form='välformade'	lemma='välforma'	feats='Case=Nom|Definite=Def|Degree=Pos|Number=Plur'	treebank='lines_test'
form='utformade'	lemma='utforma'	feats='Case=Nom|Definite=Ind|Degree=Pos|Number=Plur'	treebank='lines_test'
form='förnärmade'	lemma='förnärmad'	feats='Case=Nom|Definite=Ind|Degree=Pos|Number=Plur'	treebank='lines_test'
form='ordnade'	lemma='ordnad'	feats='Case=Nom|Definite=Ind|Degree=Pos|Number=Plur'	treebank='lines_test'
form='Förenade'	lemma='förenad'	feats='Case=Nom|Definite=Def|Degree=Pos|Gender=Neut|Number=Sing'	treebank='lines_test'
form='förenade'	lemma='förenade'	feats='Case=Nom|Definite=Def|Degree=Pos|Number=Sing'	treebank='talbanken'
form='begagnade'	lemma='begagnad'	feats='Case=Nom|Definite=Ind|Degree=Pos|Number=Plur'	treebank='lines_test'
form='välsignade'	lemma='välsignad'	feats='Case=Nom|Definite=Def|Degree=Pos|Gender=Com|Number=Sing'	treebank='lines_test'
form='akvarelltonade'	lemma='akvarelltonad'	feats='Case=Nom|Definite=Ind|Degree=Pos|Number=Plur'	treebank='lines_test'
form='skrumpnade'	lemma='skrumpna'	feats='Case=Nom|Definite=Ind|Degree=Pos|Number=Plur'	treebank='lines_test'
form='otränade'	lemma='otränad'	feats='Case=Nom|Degree=Pos|Number=Plur'	treebank='pud'
form='sparade'	lemma='spara'	feats='Case=Nom|Definite=Ind|Degree=Pos|Gender=Com|Number=Sing'	treebank='lines_test'
form='åldrade'	lemma='åldrad'	feats='Case=Nom|Definite=Ind|Number=Plur'	treebank='lines_test'
form='oförändrade'	lemma='oförändrad'	feats='Case=Nom|Definite=Ind|Degree=Pos|Number=Plur'	treebank='lines_test'
form='malplacerade'	lemma='malplacerad'	feats='Case=Nom|Definite=Ind|Number=Plur'	treebank='lines_test'
form='välkvalificerade'	lemma='välkvalificerad'	feats='Case=Nom|Definite=Ind|Degree=Pos|Number=Plur'	treebank='lines_test'
form='okomplicerade'	lemma='okomplicerad'	feats='Case=Nom|Definite=Def|Degree=Pos|Gender=Com|Number=Sing'	treebank='lines_test'
form='kanderade'	lemma='kanderad'	feats='Case=Nom|Definite=Ind|Degree=Pos|Number=Plur'	treebank='lines_dev'
form='kanderade'	lemma='kanderad'	feats='Case=Nom|Definite=Ind|Degree=Pos|Number=Plur'	treebank='lines_test'
form='broderade'	lemma='brodera'	feats='Case=Nom|Definite=Ind|Degree=Pos|Number=Plur'	treebank='lines_test'
form='utstuderade'	lemma='utstuderad'	feats='Case=Nom|Degree=Pos|Number=Plur'	treebank='pud'
form='mumifierade'	lemma='mumifiera'	feats='Case=Nom|Definite=Def|Degree=Pos|Gender=Neut|Number=Sing'	treebank='lines_test'
form='XML-definierade'	lemma='XML-definierad'	feats='Case=Nom|Definite=Ind|Degree=Pos|Number=Plur'	treebank='lines_dev'
form='fördefinierade'	lemma='fördefinierad'	feats='Case=Nom|Definite=Ind|Degree=Pos|Number=Plur'	treebank='lines_test'
form='markerade'	lemma='markerad'	feats='Case=Nom|Definite=Ind|Degree=Pos|Number=Plur'	treebank='lines_dev'
form='dubblerade'	lemma='dubblerad'	feats='Case=Nom|Definite=Ind|Degree=Pos|Number=Plur'	treebank='lines_test'
form='installerade'	lemma='installera'	feats='Case=Nom|Definite=Def|Degree=Pos|Number=Sing'	treebank='lines_dev'
form='artikulerade'	lemma='artikulera'	feats='Case=Nom|Definite=Ind|Degree=Pos|Number=Plur'	treebank='lines_dev'
form='formulerade'	lemma='formulera'	feats='Case=Nom|Definite=Ind|Degree=Pos|Number=Plur'	treebank='lines_test'
form='ackumulerade'	lemma='ackumulerad'	feats='Case=Nom|Definite=Def|Degree=Pos|Number=Sing'	treebank='lines_dev'
form='välinformerade'	lemma='välinformerad'	feats='Case=Nom|Definite=Ind|Degree=Pos|Number=Plur'	treebank='lines_dev'
form='disciplinerade'	lemma='disciplinera'	feats='Case=Nom|Definite=Def|Degree=Pos|Gender=Neut|Number=Sing'	treebank='lines_test'
form='illuminerade'	lemma='illuminerad'	feats='Case=Nom|Definite=Ind|Degree=Pos|Number=Plur'	treebank='lines_dev'
form='magasinerade'	lemma='magasinera'	feats='Case=Nom|Definite=Def|Degree=Pos|Number=Plur'	treebank='lines_test'
form='sammetsdraperade'	lemma='sammetsdraperad'	feats='Case=Nom|Definite=Def|Degree=Pos|Gender=Com|Number=Sing'	treebank='lines_test'
form='grupperade'	lemma='gruppera'	feats='Case=Nom|Definite=Ind|Degree=Pos|Number=Plur'	treebank='lines_test'
form='massakrerade'	lemma='massakrerad'	feats='Case=Nom|Definite=Def|Degree=Pos|Gender=Com|Number=Sing'	treebank='lines_test'
form='filtrerade'	lemma='filtrera'	feats='Case=Nom|Definite=Ind|Degree=Pos|Gender=Neut|Number=Sing'	treebank='lines_test'
form='XML-baserade'	lemma='XML-baserad'	feats='Case=Nom|Definite=Def|Degree=Pos|Number=Sing'	treebank='lines_test'
form='XML-baserade'	lemma='XML-baserad'	feats='Case=Nom|Definite=Def|Degree=Pos|Number=Plur'	treebank='lines_test'
form='industrialiserade'	lemma='industrialisera'	feats='Case=Nom|Definite=Ind|Degree=Pos|Number=Plur'	treebank='lines_test'
form='stiliserade'	lemma='stilisera'	feats='Case=Nom|Definite=Def|Degree=Pos|Number=Sing'	treebank='lines_dev'
form='civiliserade'	lemma='civiliserad'	feats='Case=Nom|Definite=Def|Degree=Pos|Gender=Com|Number=Sing'	treebank='lines_test'
form='civiliserade'	lemma='civiliserad'	feats='Case=Nom|Definite=Def|Degree=Pos|Number=Sing'	treebank='lines_dev'
form='civiliserade'	lemma='civiliserad'	feats='Case=Nom|Definite=Ind|Degree=Pos|Number=Plur'	treebank='lines_dev'
form='civiliserade'	lemma='civiliserad'	feats='Case=Nom|Definite=Ind|Degree=Pos|Number=Plur'	treebank='lines_test'
form='övermekaniserade'	lemma='övermekaniserad'	feats='Case=Nom|Definite=Ind|Degree=Pos|Number=Plur'	treebank='lines_test'
form='balanserade'	lemma='balanserad'	feats='Case=Nom|Definite=Ind|Degree=Pos|Number=Plur'	treebank='lines_test'
form='kasserade'	lemma='kasserad'	feats='Case=Nom|Definite=Ind|Degree=Pos|Number=Plur'	treebank='lines_test'
form='kasserade'	lemma='kassera'	feats='Case=Nom|Definite=Ind|Degree=Pos|Number=Plur'	treebank='lines_test'
form='relaterade'	lemma='relaterad'	feats='Case=Nom|Definite=Ind|Degree=Pos|Number=Plur'	treebank='lines_test'
form='XML-relaterade'	lemma='XML-relaterad'	feats='Case=Nom|Definite=Ind|Degree=Pos|Number=Plur'	treebank='lines_dev'
form='Nyexploaterade'	lemma='nyexploaterad'	feats='Case=Nom|Definite=Ind|Degree=Pos|Number=Plur'	treebank='lines_test'
form='asfalterade'	lemma='asfaltera'	feats='Case=Nom|Definite=Def|Degree=Pos|Number=Plur'	treebank='lines_test'
form='hanterade'	lemma='hantera'	feats='Case=Nom|Definite=Ind|Degree=Pos|Number=Plur'	treebank='lines_dev'
form='dokumenterade'	lemma='dokumentera'	feats='Case=Nom|Definite=Def|Degree=Pos|Gender=Com|Number=Sing'	treebank='lines_test'
form='konverterade'	lemma='konvertera'	feats='Case=Nom|Definite=Def|Degree=Pos|Gender=Com|Number=Sing'	treebank='lines_test'
form='reserverade'	lemma='reservera'	feats='Case=Nom|Definite=Ind|Degree=Pos|Number=Plur'	treebank='lines_test'
form='lagrade'	lemma='lagra'	feats='Case=Nom|Definite=Ind|Degree=Pos|Number=Plur'	treebank='lines_test'
form='utsirade'	lemma='utsirad'	feats='Case=Nom|Definite=Def|Degree=Pos|Gender=Neut|Number=Sing'	treebank='lines_test'
form='uppspärrade'	lemma='uppspärra'	feats='Case=Nom|Definite=Def|Degree=Pos|Number=Plur'	treebank='lines_test'
form='utspärrade'	lemma='utspärrad'	feats='Case=Nom|Definite=Def|Degree=Pos|Number=Plur'	treebank='lines_test'
form='ärade'	lemma='ärad'	feats='Case=Nom|Definite=Def|Degree=Pos|Gender=Com|Number=Sing'	treebank='lines_test'
form='visade'	lemma='visa'	feats='Case=Nom'	treebank='lines_dev'
form='uppassade'	lemma='uppassa'	feats='Case=Nom|Definite=Ind|Degree=Pos|Gender=Com|Number=Plur'	treebank='lines_test'
form='fernissade'	lemma='fernissa'	feats='Case=Nom|Definite=Ind|Degree=Pos|Number=Plur'	treebank='lines_test'
form='uppslitsade'	lemma='uppslitsad'	feats='Case=Nom|Definite=Ind|Degree=Pos|Number=Plur'	treebank='lines_test'
form='putsade'	lemma='putsa'	feats='Case=Nom|Definite=Ind|Degree=Pos|Number=Plur'	treebank='lines_test'
form='lyftade'	lemma='lyfta'	feats='Case=Nom|Definite=Def|Degree=Pos|Number=Plur'	treebank='lines_test'
form='besläktade'	lemma='besläktad'	feats='Case=Nom|Degree=Pos|Number=Plur'	treebank='pud'
form='oväntade'	lemma='oväntad'	feats='Case=Nom|Definite=Ind|Degree=Pos|Number=Plur'	treebank='lines_test'
form='oväntade'	lemma='oväntad'	feats='Case=Nom|Definite=Def|Degree=Pos|Number=Sing'	treebank='lines_dev'
form='oväntade'	lemma='oväntad'	feats='Case=Nom|Definite=Def|Degree=Pos'	treebank='lines_test'
form='oväntade'	lemma='oväntad'	feats='Case=Nom|Definite=Ind|Degree=Pos|Number=Plur'	treebank='lines_dev'
form='förväntade'	lemma='förväntad'	feats='Case=Nom|Definite=Ind|Degree=Pos|Number=Plur'	treebank='lines_test'
form='farsartade'	lemma='farsartad'	feats='Case=Nom|Definite=Ind|Degree=Pos|Number=Plur'	treebank='lines_test'
form='rostade'	lemma='rosta'	feats='Case=Nom|Definite=Def|Degree=Pos|Gender=Neut|Number=Sing'	treebank='lines_test'
form='rostade'	lemma='rosta'	feats='Case=Nom|Definite=Def|Degree=Pos|Gender=Com|Number=Sing'	treebank='lines_test'
form='rostade'	lemma='rosta'	feats='Case=Nom|Definite=Ind|Degree=Pos|Number=Plur'	treebank='lines_test'
form='välborstade'	lemma='välborstad'	feats='Case=Nom|Definite=Def|Degree=Pos|Number=Sing'	treebank='lines_dev'
form='sammanfattade'	lemma='sammanfatta'	feats='Case=Nom|Definite=Ind|Degree=Pos|Number=Plur'	treebank='lines_test'
form='flyttade'	lemma='flytta'	feats='Case=Nom|Definite=Def|Degree=Pos|Number=Sing'	treebank='lines_test'
form='rentvättade'	lemma='rentvätta'	feats='Case=Nom|Definite=Ind|Degree=Pos|Number=Plur'	treebank='lines_test'
form='travade'	lemma='travad'	feats='Case=Nom|Definite=Ind|Degree=Pos|Number=Plur'	treebank='lines_dev'
form='belevade'	lemma='belevad'	feats='Case=Nom|Definite=Def|Degree=Pos|Number=Sing'	treebank='lines_dev'
form='förvärvade'	lemma='förvärvad'	feats='Case=Nom|Definite=Def|Degree=Pos'	treebank='lines_dev'
form='förstfödde'	lemma='förstfödd'	feats='Case=Nom|Definite=Def|Degree=Pos|Gender=Com|Number=Sing'	treebank='lines_test'
form='enskilde'	lemma='enskild'	feats='Case=Nom|Definite=Def|Degree=Pos|Number=Sing'	treebank='lines_test'
form='enskilde'	lemma='enskild'	feats='Case=Nom|Definite=Def|Degree=Pos|Gender=Masc|Number=Sing'	treebank='talbanken'
form='berömde'	lemma='berömd'	feats='Case=Nom|Definite=Def|Degree=Pos|Number=Sing'	treebank='lines_test'
form='förberedande'	lemma='förberedande'	feats='Case=Nom|Degree=Pos'	treebank='lines_test'
form='gränsöverskridande'	lemma='gränsöverskridande'	feats='Case=Nom|Degree=Pos'	treebank='lines_test'
form='självblandande'	lemma='självblandande'	feats='Case=Nom|Definite=Ind|Degree=Pos|Number=Sing'	treebank='lines_dev'
form='bindande'	lemma='bindande'	feats='Case=Nom|Definite=Def|Degree=Pos|Number=Sing'	treebank='lines_dev'
form='bländande'	lemma='bländande'	feats='Case=Nom|Definite=Ind|Degree=Pos|Gender=Neut|Number=Sing'	treebank='lines_test'
form='bländande'	lemma='bländande'	feats='Degree=Pos'	treebank='lines_test'
form='bländande'	lemma='bländande'	feats='Case=Nom|Degree=Pos'	treebank='lines_test'
form='motbjudande'	lemma='motbjudande'	feats='Case=Nom|Degree=Pos'	treebank='lines_test'
form='olycksbådande'	lemma='olycksbådande'	feats='Case=Nom|Degree=Pos'	treebank='lines_test'
form='olycksbådande'	lemma='olycksbådande'	feats='Case=Nom|Degree=Pos'	treebank='pud'
form='iakttagande'	lemma='iakttagande'	feats='Case=Nom|Degree=Pos'	treebank='lines_test'
form='eggande'	lemma='eggande'	feats='Case=Nom|Degree=Pos'	treebank='lines_test'
form='Föreliggande'	lemma='föreliggande'	feats='Case=Nom|Definite=Def|Degree=Pos|Number=Sing'	treebank='lines_dev'
form='omkringliggande'	lemma='omkringliggande'	feats='Case=Nom|Degree=Pos'	treebank='lines_test'
form='bakomliggande'	lemma='bakomliggande'	feats='Case=Nom|Degree=Pos'	treebank='lines_test'
form='underliggande'	lemma='underliggande'	feats='Case=Nom|Degree=Pos'	treebank='lines_test'
form='närliggande'	lemma='närliggande'	feats='Case=Nom|Degree=Pos'	treebank='pud'
form='betryggande'	lemma='betryggande'	feats='Case=Nom|Definite=Ind|Degree=Pos|Gender=Neut|Number=Sing'	treebank='lines_test'
form='betryggande'	lemma='betryggande'	feats='Case=Nom|Degree=Pos'	treebank='lines_test'
form='klingande'	lemma='klingande'	feats='Case=Nom|Degree=Pos'	treebank='lines_test'
form='hängande'	lemma='hängande'	feats='Case=Nom|Degree=Pos'	treebank='lines_test'
form='genomträngande'	lemma='genomträngande'	feats='Case=Nom|Degree=Pos'	treebank='lines_test'
form='sargande'	lemma='sargande'	feats='Case=Nom|Definite=Ind|Degree=Pos|Gender=Neut|Number=Sing'	treebank='lines_test'
form='flygande'	lemma='flygande'	feats='Case=Nom|Definite=Ind|Degree=Pos|Number=Plur'	treebank='lines_dev'
form='flygande'	lemma='flygande'	feats='Case=Nom|Degree=Pos'	treebank='lines_test'
form='flygande'	lemma='flygande'	feats='Case=Nom|Definite=Ind|Degree=Pos|Gender=Neut|Number=Sing'	treebank='lines_test'
form='smygande'	lemma='smygande'	feats='Case=Nom|Definite=Ind|Degree=Pos|Gender=Neut|Number=Sing'	treebank='lines_test'
form='intetsägande'	lemma='intetsägande'	feats='Case=Nom|Degree=Pos'	treebank='lines_test'
form='frågande'	lemma='frågande'	feats='Case=Nom|Degree=Pos'	treebank='lines_test'
form='kliande'	lemma='kliande'	feats='Case=Nom|Degree=Pos'	treebank='lines_test'
form='följande'	lemma='följande'	feats='Case=Nom'	treebank='lines_test'
form='efterföljande'	lemma='efterföljande'	feats='Case=Nom|Degree=Pos'	treebank='pud'
form='förhärjande'	lemma='förhärjande'	feats='Case=Nom|Definite=Ind|Degree=Pos|Number=Sing'	treebank='lines_dev'
form='Nickande'	lemma='nickande'	feats='Case=Nom|Degree=Pos'	treebank='lines_dev'
form='stickande'	lemma='stickande'	feats='Case=Nom|Degree=Pos'	treebank='lines_test'
form='vederkvickande'	lemma='vederkvickande'	feats='Case=Nom|Degree=Pos'	treebank='lines_test'
form='läckande'	lemma='läckande'	feats='Case=Nom|Degree=Pos'	treebank='lines_test'
form='förtroendeväckande'	lemma='förtroendeväckande'	feats='Case=Nom|Degree=Pos'	treebank='lines_test'
form='häpnadsväckande'	lemma='häpnadsväckande'	feats='Case=Nom|Definite=Def|Degree=Pos|Number=Sing'	treebank='lines_dev'
form='skrikande'	lemma='skrikande'	feats='Case=Nom|Degree=Pos'	treebank='lines_test'
form='annalkande'	lemma='annalkande'	feats='Case=Nom|Degree=Pos'	treebank='lines_test'
form='stinkande'	lemma='stinkande'	feats='Case=Nom'	treebank='lines_test'
form='vinkande'	lemma='vinkande'	feats='Case=Nom|Degree=Pos'	treebank='lines_test'
form='dunkande'	lemma='dunkande'	feats='Case=Nom|Definite=Ind|Degree=Pos|Number=Sing'	treebank='lines_test'
form='dunkande'	lemma='dunkande'	feats='Case=Nom|Definite=Ind|Degree=Pos|Number=Sing'	treebank='lines_dev'
form='sjunkande'	lemma='sjunkande'	feats='Case=Nom|Definite=Ind|Degree=Pos|Number=Sing'	treebank='lines_dev'
form='prunkande'	lemma='prunkande'	feats='Case=Nom|Definite=Ind|Degree=Pos|Number=Plur'	treebank='lines_dev'
form='blänkande'	lemma='blänkande'	feats='Case=Nom|Definite=Ind|Degree=Pos|Gender=Neut|Number=Sing'	treebank='lines_test'
form='vitblänkande'	lemma='vitblänkande'	feats='Case=Nom|Degree=Pos'	treebank='lines_test'
form='kränkande'	lemma='kränkande'	feats='Case=Nom|Definite=Ind|Degree=Pos|Number=Sing'	treebank='lines_dev'
form='tänkande'	lemma='tänkande'	feats='Case=Nom'	treebank='lines_test'
form='slokande'	lemma='slokande'	feats='Case=Nom|Degree=Pos'	treebank='lines_test'
form='värkande'	lemma='värkande'	feats='Case=Nom|Degree=Pos'	treebank='lines_test'
form='överraskande'	lemma='överraskande'	feats='Case=Nom|Degree=Pos'	treebank='lines_test'
form='brådskande'	lemma='brådskande'	feats='Case=Nom|Definite=Def|Degree=Pos|Number=Sing'	treebank='lines_dev'
form='uppfriskande'	lemma='uppfriskande'	feats='Case=Nom|Degree=Pos'	treebank='lines_test'
form='grönskande'	lemma='grönskande'	feats='Case=Nom|Degree=Pos'	treebank='lines_test'
form='forskande'	lemma='forskande'	feats='Case=Nom|Definite=Ind|Degree=Pos|Number=Sing'	treebank='lines_dev'
form='ökande'	lemma='ökande'	feats='Case=Nom|Degree=Pos'	treebank='lines_test'
form='talande'	lemma='talande'	feats='Case=Nom|Definite=Def|Degree=Pos|Number=Sing'	treebank='lines_dev'
form='lambala-talande'	lemma='lambala-talande'	feats='Case=Nom|Degree=Pos'	treebank='lines_test'
form='snubblande'	lemma='snubblande'	feats='Case=Nom|Degree=Pos'	treebank='lines_test'
form='vindlande'	lemma='vindlande'	feats='Case=Nom|Degree=Pos'	treebank='lines_test'
form='svindlande'	lemma='svindlande'	feats='Case=Nom'	treebank='lines_test'
form='förbiilande'	lemma='förbiilande'	feats='Case=Nom|Degree=Pos'	treebank='lines_test'
form='hycklande'	lemma='hycklande'	feats='Case=Nom|Degree=Pos'	treebank='lines_test'
form='iögonenfallande'	lemma='iögonenfallande'	feats='Case=Nom|Degree=Pos'	treebank='lines_test'
form='iögonfallande'	lemma='iögonfallande'	feats='Case=Nom|Degree=Pos'	treebank='pud'
form='förbryllande'	lemma='förbryllande'	feats='Case=Nom|Degree=Pos'	treebank='lines_test'
form='skrällande'	lemma='skrällande'	feats='Case=Nom|Degree=Pos'	treebank='lines_test'
form='verkställande'	lemma='verkställande'	feats='Case=Nom|Degree=Pos'	treebank='pud'
form='framvällande'	lemma='framvällande'	feats='Case=Nom|Definite=Def|Degree=Pos|Number=Sing'	treebank='lines_dev'
form='ihållande'	lemma='ihållande'	feats='Case=Nom|Degree=Pos'	treebank='lines_test'
form='mumlande'	lemma='mumlande'	feats='Case=Nom|Definite=Ind|Degree=Pos|Gender=Neut|Number=Sing'	treebank='lines_test'
form='omtumlande'	lemma='omtumlande'	feats='Case=Nom|Degree=Pos'	treebank='lines_test'
form='sorlande'	lemma='sorlande'	feats='Case=Nom|Degree=Pos'	treebank='lines_test'
form='visslande'	lemma='visslande'	feats='Case=Nom|Definite=Ind|Degree=Pos|Gender=Neut|Number=Sing'	treebank='lines_test'
form='virvlande'	lemma='virvlande'	feats='Case=Nom|Degree=Pos'	treebank='lines_test'
form='Strålande'	lemma='strålande'	feats='Case=Nom|Degree=Pos'	treebank='lines_test'
form='strålande'	lemma='strålande'	feats='Case=Nom|Definite=Ind|Degree=Pos|Number=Plur'	treebank='lines_dev'
form='strålande'	lemma='strålande'	feats='Case=Nom|Degree=Pos'	treebank='lines_test'
form='glimmande'	lemma='glimmande'	feats='Case=Nom|Degree=Pos'	treebank='lines_test'
form='glimmande'	lemma='glimmande'	feats='Case=Nom|Definite=Def|Degree=Pos|Number=Plur'	treebank='lines_dev'
form='kommande'	lemma='kommande'	feats='Case=Nom|Degree=Pos'	treebank='lines_test'
form='förekommande'	lemma='förekommande'	feats='Case=Nom|Degree=Pos'	treebank='lines_test'
form='beklämmande'	lemma='beklämmande'	feats='Case=Nom|Degree=Pos'	treebank='lines_test'
form='strömmande'	lemma='strömmande'	feats='Case=Nom|Degree=Pos'	treebank='lines_test'
form='utmanande'	lemma='utmanande'	feats='Case=Nom|Definite=Ind|Degree=Pos|Number=Sing'	treebank='lines_dev'
form='välmenande'	lemma='välmenande'	feats='Case=Nom|Definite=Ind|Degree=Pos|Number=Plur'	treebank='lines_dev'
form='flagnande'	lemma='flagnande'	feats='Case=Nom|Definite=Ind|Degree=Pos|Number=Sing'	treebank='lines_dev'
form='skinande'	lemma='skinande'	feats='Case=Nom|Degree=Pos'	treebank='lines_test'
form='XML-liknande'	lemma='XML-liknande'	feats='Case=Nom|Degree=Pos'	treebank='lines_test'
form='kerubliknande'	lemma='kerubliknande'	feats='Case=Nom|Definite=Ind|Degree=Pos|Number=Sing'	treebank='lines_dev'
form='kalkylbladsliknande'	lemma='kalkylbladsliknande'	feats='Case=Nom|Degree=Pos'	treebank='lines_test'
form='dödsliknande'	lemma='dödsliknande'	feats='Case=Nom|Degree=Pos'	treebank='lines_test'
form='växtsaftsliknande'	lemma='växtsaftsliknande'	feats='Case=Nom|Definite=Ind|Degree=Pos|Number=Sing'	treebank='lines_dev'
form='fladdermusliknande'	lemma='fladdermuslikna'	feats='Case=Nom|Degree=Pos'	treebank='lines_test'
form='hästliknande'	lemma='hästliknande'	feats='Case=Nom|Definite=Ind|Degree=Pos|Gender=Neut|Number=Sing'	treebank='lines_test'
form='avsmalnande'	lemma='avsmalnande'	feats='Case=Nom|Degree=Pos'	treebank='lines_test'
form='hämnande'	lemma='hämnande'	feats='Case=Nom|Degree=Pos'	treebank='lines_test'
form='brinnande'	lemma='brinnande'	feats='Case=Nom|Definite=Ind|Degree=Pos|Gender=Neut|Number=Sing'	treebank='lines_test'
form='brinnande'	lemma='brinnande'	feats='Case=Nom|Definite=Ind|Degree=Pos|Number=Sing'	treebank='lines_dev'
form='begynnande'	lemma='begynnande'	feats='Case=Nom|Degree=Pos'	treebank='lines_test'
form='medkännande'	lemma='medkännande'	feats='Case=Nom|Degree=Pos'	treebank='pud'
form='ansvarskännande'	lemma='ansvarskännande'	feats='Case=Nom|Degree=Pos'	treebank='lines_test'
form='spännande'	lemma='spännande'	feats='Case=Nom|Degree=Pos'	treebank='lines_test'
form='spännande'	lemma='spännande'	feats='Case=Nom|Definite=Ind|Degree=Pos|Gender=Neut|Number=Sing'	treebank='lines_test'
form='spännande'	lemma='spännande'	feats='Case=Nom'	treebank='lines_test'
form='spännande'	lemma='spännande'	feats='Case=Nom|Definite=Ind|Degree=Pos|Number=Sing'	treebank='lines_dev'
form='försonande'	lemma='försonande'	feats='Case=Nom|Degree=Pos'	treebank='lines_test'
form='djupnande'	lemma='djupnande'	feats='Case=Nom|Degree=Pos'	treebank='lines_test'
form='varnande'	lemma='varnande'	feats='Case=Nom|Definite=Ind|Degree=Pos|Number=Sing'	treebank='lines_dev'
form='ruttnande'	lemma='ruttnande'	feats='Case=Nom|Degree=Pos'	treebank='lines_test'
form='dånande'	lemma='dånande'	feats='Case=Nom|Degree=Pos'	treebank='lines_test'
form='hoande'	lemma='hoande'	feats='Case=Nom|Definite=Ind|Degree=Pos|Gender=Neut|Number=Sing'	treebank='lines_test'
form='oroande'	lemma='oroande'	feats='Case=Nom|Definite=Def|Degree=Pos|Number=Sing'	treebank='lines_dev'
form='nationsskapande'	lemma='nationsskapande'	feats='Case=Nom|Degree=Pos'	treebank='lines_test'
form='inkomstskapande'	lemma='inkomstskapande'	feats='Case=Nom|Degree=Pos'	treebank='lines_test'
form='svepande'	lemma='svepande'	feats='Case=Nom|Definite=Ind|Degree=Pos|Number=Sing'	treebank='lines_dev'
form='pipande'	lemma='pipande'	feats='Case=Nom|Degree=Pos'	treebank='lines_test'
form='övergripande'	lemma='övergripande'	feats='Case=Nom|Definite=Ind|Degree=Pos|Number=Plur'	treebank='lines_dev'
form='övergripande'	lemma='övergripande'	feats='Case=Nom|Definite=Ind|Degree=Pos|Gender=Neut|Number=Sing'	treebank='lines_test'
form='krympande'	lemma='krympande'	feats='Case=Nom|Degree=Pos'	treebank='lines_test'
form='frånvarande'	lemma='frånvarande'	feats='Case=Nom|Degree=Pos'	treebank='lines_test'
form='frånvarande'	lemma='frånvarande'	feats='Case=Nom|Definite=Ind|Degree=Pos|Number=Sing'	treebank='lines_dev'
form='frånvarande'	lemma='frånvarande'	feats='Case=Nom|Definite=Ind|Degree=Pos|Gender=Neut|Number=Sing'	treebank='lines_test'
form='hittillsvarande'	lemma='hittillsvarande'	feats='Case=Nom|Degree=Pos'	treebank='lines_test'
form='dåvarande'	lemma='dåvarande'	feats='Case=Nom|Degree=Pos'	treebank='pud'
form='fladdrande'	lemma='fladdrande'	feats='Case=Nom|Degree=Pos'	treebank='lines_test'
form='vandrande'	lemma='vandrande'	feats='Case=Nom|Degree=Pos'	treebank='lines_test'
form='undrande'	lemma='undrande'	feats='Case=Nom|Degree=Pos'	treebank='lines_test'
form='nattvagabonderande'	lemma='nattvagabonderande'	feats='Case=Nom|Degree=Pos'	treebank='lines_test'
form='chockerande'	lemma='chockerande'	feats='Case=Nom|Degree=Pos'	treebank='lines_test'
form='överreglerande'	lemma='överreglerande'	feats='Case=Nom|Degree=Pos'	treebank='lines_test'
form='självreglerande'	lemma='självreglerande'	feats='Case=Nom|Definite=Ind|Degree=Pos'	treebank='lines_dev'
form='vibrerande'	lemma='vibrerande'	feats='Case=Nom|Degree=Pos'	treebank='lines_test'
form='grimaserande'	lemma='grimaserande'	feats='Case=Nom|Degree=Pos'	treebank='lines_test'
form='briserande'	lemma='briserande'	feats='Case=Nom|Degree=Pos'	treebank='lines_test'
form='balanserande'	lemma='balanserande'	feats='Case=Nom|Degree=Pos'	treebank='lines_dev'
form='resterande'	lemma='resterande'	feats='Case=Nom|Degree=Pos'	treebank='lines_test'
form='existerande'	lemma='existerande'	feats='Case=Nom|Degree=Pos'	treebank='lines_test'
form='enerverande'	lemma='enerverande'	feats='Case=Nom|Degree=Pos'	treebank='lines_test'
form='slingrande'	lemma='slingrande'	feats='Case=Nom|Degree=Pos'	treebank='lines_test'
form='mullrande'	lemma='mullrande'	feats='Case=Nom|Degree=Pos'	treebank='lines_test'
form='silverskimrande'	lemma='silverskimrande'	feats='Case=Nom|Degree=Pos'	treebank='lines_test'
form='uppåtsipprande'	lemma='uppåtsipprande'	feats='Case=Nom|Definite=Ind|Degree=Pos|Number=Sing'	treebank='lines_dev'
form='stirrande'	lemma='stirrande'	feats='Case=Nom|Definite=Ind|Degree=Pos|Gender=Neut|Number=Sing'	treebank='lines_test'
form='knorrande'	lemma='knorrande'	feats='Case=Nom|Definite=Ind|Degree=Pos|Number=Sing'	treebank='lines_dev'
form='gnistrande'	lemma='gnistrande'	feats='Case=Nom|Degree=Pos'	treebank='lines_test'
form='glittrande'	lemma='glittrande'	feats='Case=Nom|Definite=Ind|Degree=Pos|Number=Plur'	treebank='lines_dev'
form='glittrande'	lemma='glittrande'	feats='Degree=Pos'	treebank='lines_test'
form='vittrande'	lemma='vittrande'	feats='Case=Nom|Degree=Pos'	treebank='lines_test'
form='blixtrande'	lemma='blixtrande'	feats='Case=Nom|Definite=Ind|Degree=Pos|Number=Plur'	treebank='lines_dev'
form='lurande'	lemma='lurande'	feats='Case=Nom|Degree=Pos'	treebank='lines_test'
form='välgörande'	lemma='välgörande'	feats='Case=Nom|Degree=Pos'	treebank='lines_test'
form='välgörande'	lemma='välgörande'	feats='Case=Nom|Definite=Ind|Degree=Pos|Number=Plur'	treebank='lines_dev'
form='välgörande'	lemma='välgörande'	feats='Case=Nom|Definite=Def|Degree=Pos|Number=Sing'	treebank='lines_dev'
form='upprörande'	lemma='upprörande'	feats='Case=Nom|Degree=Pos'	treebank='lines_test'
form='hasande'	lemma='hasande'	feats='Case=Nom|Degree=Pos'	treebank='lines_test'
form='rasande'	lemma='rasande'	feats='Case=Nom|Degree=Pos'	treebank='lines_test'
form='rasande'	lemma='rasande'	feats='Case=Nom|Definite=Ind|Degree=Pos|Gender=Neut|Number=Sing'	treebank='lines_test'
form='avvisande'	lemma='avvisande'	feats='Case=Nom|Degree=Pos'	treebank='lines_test'
form='glänsande'	lemma='glänsande'	feats='Case=Nom|Definite=Ind|Degree=Pos|Gender=Neut|Number=Sing'	treebank='lines_test'
form='glänsande'	lemma='glänsande'	feats='Case=Nom|Degree=Pos'	treebank='lines_dev'
form='glänsande'	lemma='glänsande'	feats='Case=Nom|Degree=Pos'	treebank='lines_test'
form='silverglänsande'	lemma='silverglänsande'	feats='Case=Nom|Degree=Pos'	treebank='lines_test'
form='svettglänsande'	lemma='svettglänsande'	feats='Case=Nom|Degree=Pos'	treebank='lines_test'
form='Förtjusande'	lemma='förtjusande'	feats='Case=Nom|Definite=Ind|Degree=Pos|Number=Sing'	treebank='lines_dev'
form='förtjusande'	lemma='förtjusande'	feats='Case=Nom|Degree=Pos'	treebank='lines_test'
form='lysande'	lemma='lysande'	feats='Case=Nom|Definite=Ind|Degree=Pos|Number=Plur'	treebank='lines_dev'
form='lysande'	lemma='lysande'	feats='Case=Nom|Degree=Pos'	treebank='lines_test'
form='självlysande'	lemma='självlysande'	feats='Case=Nom|Degree=Pos'	treebank='lines_test'
form='väsande'	lemma='väsande'	feats='Case=Nom|Degree=Pos'	treebank='lines_test'
form='väsande'	lemma='väsande'	feats='Case=Nom|Definite=Ind|Degree=Pos|Number=Sing'	treebank='lines_dev'
form='flåsande'	lemma='flåsande'	feats='Case=Nom|Degree=Pos'	treebank='lines_test'
form='lagstiftande'	lemma='lagstiftande'	feats='Case=Nom|Degree=Pos'	treebank='lines_test'
form='doftande'	lemma='doftande'	feats='Case=Nom|Degree=Pos'	treebank='lines_test'
form='bitande'	lemma='bitande'	feats='Degree=Pos'	treebank='lines_test'
form='Voltande'	lemma='voltande'	feats='Case=Nom|Definite=Ind|Degree=Pos|Number=Plur'	treebank='lines_dev'
form='smältande'	lemma='smältande'	feats='Case=Nom|Degree=Pos'	treebank='lines_test'
form='skymtande'	lemma='skymtande'	feats='Case=Nom|Degree=Pos'	treebank='lines_test'
form='flämtande'	lemma='flämtande'	feats='Case=Nom|Degree=Pos'	treebank='lines_test'
form='hotande'	lemma='hotande'	feats='Case=Nom|Degree=Pos'	treebank='lines_test'
form='hotande'	lemma='hotande'	feats='Case=Nom|Definite=Ind|Degree=Pos|Gender=Neut|Number=Sing'	treebank='lines_test'
form='påfrestande'	lemma='påfrestande'	feats='Case=Nom|Definite=Ind|Degree=Pos|Gender=Neut|Number=Sing'	treebank='lines_test'
form='uppskattande'	lemma='uppskattande'	feats='Case=Nom|Degree=Pos'	treebank='lines_test'
form='sittande'	lemma='sittande'	feats='Case=Nom|Degree=Pos'	treebank='lines_dev'
form='stillasittande'	lemma='stillasittande'	feats='Case=Nom|Definite=Ind|Degree=Pos|Number=Sing'	treebank='lines_dev'
form='sluttande'	lemma='sluttande'	feats='Case=Nom|Definite=Def|Degree=Pos|Number=Sing'	treebank='lines_dev'
form='lutande'	lemma='lutande'	feats='Case=Nom|Degree=Pos'	treebank='lines_test'
form='halsbrytande'	lemma='halsbrytande'	feats='Case=Nom|Degree=Pos'	treebank='lines_test'
form='havande'	lemma='havande'	feats='Case=Nom|Degree=Pos'	treebank='lines_test'
form='levande'	lemma='levande'	feats='Case=Nom|Degree=Pos'	treebank='lines_test'
form='förblivande'	lemma='förbli'	feats='Case=Nom|Degree=Pos'	treebank='lines_test'
form='upprivande'	lemma='uppriva'	feats='Case=Nom|Degree=Pos'	treebank='lines_test'
form='förgrovande'	lemma='förgrovande'	feats='Case=Nom|Degree=Pos'	treebank='lines_test'
form='sovande'	lemma='sovande'	feats='Case=Nom|Degree=Pos'	treebank='lines_test'
form='ruvande'	lemma='ruvande'	feats='Case=Nom|Definite=Ind|Degree=Pos|Gender=Neut|Number=Sing'	treebank='lines_test'
form='ruvande'	lemma='ruvande'	feats='Case=Nom|Degree=Pos'	treebank='lines_test'
form='krävande'	lemma='krävande'	feats='Case=Nom|Degree=Pos'	treebank='lines_test'
form='energikrävande'	lemma='energikräva'	feats='Case=Nom|Degree=Pos'	treebank='lines_test'
form='svävande'	lemma='svävande'	feats='Case=Nom|Definite=Ind|Degree=Pos|Gender=Neut|Number=Sing'	treebank='lines_test'
form='svävande'	lemma='svävande'	feats='Case=Nom|Degree=Pos'	treebank='lines_test'
form='öronbedövande'	lemma='öronbedövande'	feats='Case=Nom|Definite=Ind|Degree=Pos|Gender=Neut|Number=Sing'	treebank='lines_test'
form='behövande'	lemma='behövande'	feats='Case=Nom|Degree=Pos'	treebank='lines_test'
form='leende'	lemma='le'	feats='Case=Nom'	treebank='lines_test'
form='överseende'	lemma='överseende'	feats='Case=Nom|Definite=Ind|Degree=Pos|Gender=Neut|Number=Sing'	treebank='lines_test'
form='filoberoende'	lemma='filoberoende'	feats='Case=Nom|Degree=Pos'	treebank='lines_test'
form='plattformsoberoende'	lemma='plattformsoberoende'	feats='Case=Nom|Definite=Ind|Degree=Pos|Number=Plur'	treebank='lines_dev'
form='föregående'	lemma='föregående'	feats='Case=Nom|Degree=Pos'	treebank='pud'
form='kringgående'	lemma='kringgående'	feats='Case=Nom|Degree=Pos'	treebank='lines_test'
form='ingående'	lemma='ingående'	feats='Case=Nom'	treebank='lines_test'
form='långtgående'	lemma='långtgående'	feats='Case=Nom|Degree=Pos'	treebank='pud'
form='pågående'	lemma='pågående'	feats='Case=Nom|Degree=Pos'	treebank='lines_test'
form='sjögående'	lemma='sjögående'	feats='Case=Nom|Degree=Pos'	treebank='lines_test'
form='stillastående'	lemma='stillastående'	feats='Case=Nom|Degree=Pos'	treebank='lines_test'
?form='enastående'	lemma='enastående'	feats='Case=Nom|Definite=Ind|Degree=Pos|Number=Sing'	treebank='lines_dev'
?form='enastående'	lemma='enastående'	feats='Case=Nom|Definite=Ind|Degree=Pos|Number=Sing'	treebank='lines_test'
form='förestående'	lemma='förestå'	feats='Case=Nom|Degree=Pos'	treebank='lines_test'
form='framstående'	lemma='framstående'	feats='Case=Nom|Degree=Pos'	treebank='pud'
form='utomstående'	lemma='utomstående'	feats='Case=Nom|Degree=Pos'	treebank='pud'
form='utstående'	lemma='utstående'	feats='Case=Nom|Degree=Pos'	treebank='lines_test'
form='lärde'	lemma='lära'	feats='Case=Nom|Degree=Pos|Number=Plur'	treebank='talbanken'
form='döde'	lemma='död'	feats='Case=Nom|Definite=Def|Degree=Pos|Number=Sing'	treebank='lines_test'
form='beriden'	lemma='beriden'	feats='Case=Nom|Definite=Ind|Degree=Pos|Number=Sing'	treebank='lines_dev'
form='förvriden'	lemma='förvriden'	feats='Case=Nom|Definite=Ind|Degree=Pos|Number=Sing'	treebank='lines_dev'
form='skräckslagen'	lemma='skräckslagen'	feats='Case=Nom|Definite=Ind|Degree=Pos|Number=Sing'	treebank='lines_dev'
form='lamslagen'	lemma='lamslagen'	feats='Case=Nom|Definite=Ind|Degree=Pos|Gender=Com|Number=Sing'	treebank='lines_test'
form='uppslagen'	lemma='uppslagen'	feats='Case=Nom|Definite=Ind|Degree=Pos|Gender=Com|Number=Sing'	treebank='lines_test'
form='blåslagen'	lemma='blåslagen'	feats='Case=Nom|Definite=Ind|Degree=Pos|Gender=Com|Number=Sing'	treebank='lines_test'
form='tillbakadragen'	lemma='tillbakadragen'	feats='Case=Nom|Definite=Ind|Degree=Pos|Gender=Com|Number=Sing'	treebank='lines_test'
form='utdragen'	lemma='utdragen'	feats='Case=Nom|Definite=Ind|Degree=Pos|Gender=Com|Number=Sing'	treebank='lines_test'
form='upptagen'	lemma='upptagen'	feats='Case=Nom|Definite=Ind|Degree=Pos|Gender=Com|Number=Sing'	treebank='lines_test'
form='ålderstigen'	lemma='ålderstigen'	feats='Case=Nom|Definite=Ind|Degree=Pos|Number=Sing'	treebank='lines_dev'
form='ålderstigen'	lemma='ålderstigen'	feats='Case=Nom|Definite=Ind|Degree=Pos|Gender=Com|Number=Sing'	treebank='lines_test'
form='påkommen'	lemma='påkommen'	feats='Case=Nom|Definite=Ind|Degree=Pos|Gender=Com|Number=Sing'	treebank='lines_test'
form='häpen'	lemma='häpen'	feats='Case=Nom|Definite=Ind|Degree=Pos|Gender=Com|Number=Sing'	treebank='lines_test'
form='erfaren'	lemma='erfaren'	feats='Case=Nom|Definite=Ind|Degree=Pos|Gender=Com|Number=Sing'	treebank='talbanken'
form='oerfaren'	lemma='oerfaren'	feats='Case=Nom|Definite=Ind|Degree=Pos|Gender=Com|Number=Sing'	treebank='talbanken'
form='finskuren'	lemma='finskuren'	feats='Case=Nom|Definite=Ind|Degree=Pos|Gender=Com|Number=Sing'	treebank='lines_test'
form='medsvuren'	lemma='medsvuren'	feats='Case=Nom|Definite=Ind|Degree=Pos|Gender=Com|Number=Sing'	treebank='lines_test'
form='medveten'	lemma='medveten'	feats='Case=Nom|Definite=Ind|Degree=Pos|Number=Sing'	treebank='lines_dev'
form='medveten'	lemma='medveten'	feats='Case=Nom|Definite=Ind|Degree=Pos|Gender=Com|Number=Sing'	treebank='lines_dev'
form='medveten'	lemma='medveten'	feats='Case=Nom|Definite=Ind|Degree=Pos|Gender=Com|Number=Sing'	treebank='lines_test'
form='medveten'	lemma='medveten'	feats='Case=Nom|Definite=Ind|Degree=Pos|Gender=Com|Number=Sing'	treebank='talbanken'
form='medveten'	lemma='medveten'	feats='Case=Nom|Definite=Ind|Degree=Pos|Gender=Com|Number=Sing'	treebank='pud'
form='målmedveten'	lemma='målmedveten'	feats='Case=Nom|Definite=Ind|Degree=Pos|Gender=Com|Number=Sing'	treebank='talbanken'
form='omedveten'	lemma='omedveten'	feats='Case=Nom|Definite=Ind|Degree=Pos|Gender=Com|Number=Sing'	treebank='lines_dev'
form='sliten'	lemma='sliten'	feats='Case=Nom|Definite=Ind|Degree=Pos|Gender=Com|Number=Sing'	treebank='lines_test'
form='sliten'	lemma='sliten'	feats='Case=Nom|Definite=Ind|Degree=Pos|Number=Sing'	treebank='lines_dev'
form='utsvulten'	lemma='utsvulten'	feats='Case=Nom|Definite=Ind|Degree=Pos|Gender=Com|Number=Sing'	treebank='lines_test'
form='ärelysten'	lemma='ärelysten'	feats='Case=Nom|Definite=Ind|Degree=Pos|Gender=Com|Number=Sing'	treebank='lines_dev'
form='stridslysten'	lemma='stridslysten'	feats='Case=Nom|Definite=Ind|Degree=Pos|Number=Sing'	treebank='lines_dev'
form='besluten'	lemma='besluten'	feats='Case=Nom|Definite=Ind|Degree=Pos|Gender=Com|Number=Sing'	treebank='lines_test'
form='tillåten'	lemma='tillåten'	feats='Case=Nom|Definite=Ind|Degree=Pos|Gender=Com|Number=Sing'	treebank='talbanken'
form='tillåten'	lemma='tillåten'	feats='Case=Nom|Definite=Def|Gender=Com|Number=Sing'	treebank='lines_test'
form='övergiven'	lemma='överge'	feats='Case=Nom|Definite=Ind|Degree=Pos|Gender=Com|Number=Sing'	treebank='lines_test'
form='vuxen'	lemma='vuxen'	feats='Case=Nom|Definite=Ind|Degree=Pos|Gender=Com|Number=Sing'	treebank='talbanken'
form='kortvuxen'	lemma='kortvuxen'	feats='Case=Nom|Definite=Ind|Degree=Pos|Number=Sing'	treebank='lines_dev'
form='fastvuxen'	lemma='fastvuxen'	feats='Case=Nom|Definite=Ind|Degree=Pos|Number=Sing'	treebank='lines_dev'
form='halvvuxen'	lemma='halvvuxen'	feats='Case=Nom|Definite=Ind|Degree=Pos|Gender=Com|Number=Sing'	treebank='lines_test'
form='skrivskyddat'	lemma='skrivskyddad'	feats='Case=Nom|Definite=Ind|Degree=Pos|Gender=Neut|Number=Sing'	treebank='lines_test'
form='inblandat'	lemma='inblandad'	feats='Case=Nom|Definite=Ind|Degree=Pos|Gender=Neut|Number=Sing'	treebank='lines_test'
form='förargat'	lemma='förargad'	feats='Case=Nom|Definite=Ind|Degree=Pos|Gender=Neut|Number=Sing'	treebank='lines_test'
form='Delat'	lemma='dela'	feats='Case=Nom|Definite=Ind|Degree=Pos|Gender=Neut|Number=Sing'	treebank='lines_test'
form='välformat'	lemma='välformad'	feats='Case=Nom|Definite=Ind|Degree=Pos|Gender=Neut|Number=Sing'	treebank='lines_test'
form='utformat'	lemma='utformad'	feats='Case=Nom|Definite=Ind|Degree=Pos|Gender=Neut|Number=Sing'	treebank='lines_test'
form='beräknat'	lemma='beräknad'	feats='Case=Nom|Definite=Ind|Degree=Pos|Gender=Neut|Number=Sing'	treebank='lines_test'
form='förbannat'	lemma='förbannad'	feats='Case=Nom|Definite=Ind|Degree=Pos|Number=Sing'	treebank='lines_dev'
form='ombonat'	lemma='ombonad'	feats='Case=Nom|Definite=Ind|Degree=Pos|Gender=Neut|Number=Sing'	treebank='lines_test'
form='ödesbetonat'	lemma='ödesbetonad'	feats='Case=Nom|Definite=Ind|Degree=Pos|Number=Sing'	treebank='lines_dev'
form='roat'	lemma='road'	feats='Case=Nom|Definite=Ind|Degree=Pos|Gender=Neut|Number=Sing'	treebank='lines_test'
form='grönfodrat'	lemma='grönfodrad'	feats='Case=Nom|Definite=Ind|Degree=Pos|Number=Sing'	treebank='lines_dev'
form='komplicerat'	lemma='komplicerad'	feats='Case=Nom|Definite=Ind|Degree=Pos|Gender=Neut|Number=Sing'	treebank='lines_test'
form='Filtrerat'	lemma='filtrera'	feats='Case=Nom|Definite=Ind|Degree=Pos|Gender=Neut|Number=Sing'	treebank='lines_test'
form='XML-baserat'	lemma='XML-baserad'	feats='Case=Nom|Definite=Ind|Degree=Pos|Gender=Neut|Number=Sing'	treebank='lines_test'
form='standardbaserat'	lemma='standardbaserad'	feats='Case=Nom|Definite=Ind|Degree=Pos|Number=Sing'	treebank='lines_dev'
form='civiliserat'	lemma='civiliserad'	feats='Case=Nom|Definite=Ind|Degree=Pos|Gender=Neut|Number=Sing'	treebank='lines_test'
form='balanserat'	lemma='balanserad'	feats='Case=Nom|Definite=Ind|Degree=Pos|Gender=Neut|Number=Sing'	treebank='lines_test'
form='bekymrat'	lemma='bekymrad'	feats='Case=Nom|Definite=Ind|Degree=Pos|Gender=Neut|Number=Sing'	treebank='lines_test'
form='upphetsat'	lemma='upphetsad'	feats='Case=Nom|Definite=Ind|Degree=Pos|Number=Sing'	treebank='lines_dev'
form='berusat'	lemma='berusad'	feats='Case=Nom|Definite=Ind|Degree=Pos|Gender=Neut|Number=Sing'	treebank='lines_test'
form='omtvistat'	lemma='omtvistad'	feats='Case=Nom|Definite=Ind|Degree=Pos|Gender=Neut|Number=Sing'	treebank='pud'
form='lättvättat'	lemma='lättvättad'	feats='Case=Nom|Definite=Ind|Gender=Neut|Number=Sing'	treebank='lines_test'
form='avlutat'	lemma='avlutad'	feats='Case=Nom|Definite=Ind|Degree=Pos|Gender=Neut|Number=Sing'	treebank='lines_test'
form='överståndet'	lemma='överstånden'	feats='Case=Nom|Definite=Ind|Degree=Pos|Gender=Neut|Number=Sing'	treebank='lines_test'
form='sönderslaget'	lemma='sönderslagen'	feats='Case=Nom|Definite=Ind|Degree=Pos|Gender=Neut|Number=Sing'	treebank='lines_test'
form='upptaget'	lemma='upptagen'	feats='Case=Nom|Definite=Ind|Degree=Pos|Gender=Neut|Number=Sing'	treebank='lines_test'
form='försjunket'	lemma='försjunken'	feats='Case=Nom|Definite=Ind|Degree=Pos|Gender=Neut|Number=Sing'	treebank='lines_test'
form='förstulet'	lemma='förstulen'	feats='Case=Nom|Definite=Ind|Degree=Pos|Gender=Neut|Number=Sing'	treebank='lines_test'
form='vilsekommet'	lemma='vilsekommen'	feats='Case=Nom|Definite=Ind|Degree=Pos|Gender=Neut|Number=Sing'	treebank='lines_test'
form='kringskuret'	lemma='kringskära'	feats='Case=Nom|Definite=Ind|Degree=Pos|Gender=Neut|Number=Sing'	treebank='lines_test'
form='omedvetet'	lemma='omedveten'	feats='Case=Nom|Definite=Ind|Degree=Pos|Gender=Neut|Number=Sing'	treebank='lines_test'
form='luggslitet'	lemma='luggsliten'	feats='Case=Nom|Definite=Ind|Degree=Pos|Number=Sing'	treebank='lines_dev'
form='avslitet'	lemma='avslita'	feats='Case=Nom|Definite=Ind|Degree=Pos|Gender=Neut|Number=Sing'	treebank='lines_test'
form='oavbrutet'	lemma='oavbruten'	feats='Case=Nom|Definite=Ind|Degree=Pos|Gender=Neut|Number=Sing'	treebank='lines_test'
form='otillåtet'	lemma='otillåten'	feats='Case=Nom|Definite=Ind|Degree=Pos|Number=Sing'	treebank='lines_dev'
form='givet'	lemma='givet'	feats='Case=Nom|Definite=Def|Gender=Neut|Number=Sing'	treebank='lines_test'
form='omgift'	lemma='omgift'	feats='Case=Nom|Definite=Ind|Degree=Pos|Gender=Com|Number=Sing'	treebank='lines_test'
form='ogift'	lemma='ogift'	feats='Case=Nom|Definite=Ind|Degree=Pos|Gender=Neut|Number=Sing'	treebank='talbanken'
form='ogift'	lemma='ogift'	feats='Case=Nom|Definite=Ind|Degree=Pos|Gender=Com|Number=Sing'	treebank='talbanken'
form='upplyft'	lemma='upplyfta'	feats='Case=Nom|Definite=Ind|Number=Sing'	treebank='lines_dev'
form='uppbragt'	lemma='uppbragd'	feats='Case=Nom|Definite=Ind|Degree=Pos|Number=Sing'	treebank='lines_dev'
form='inbyggt'	lemma='inbygga'	feats='Case=Nom|Definite=Ind|Degree=Pos|Number=Sing'	treebank='lines_dev'
form='instängt'	lemma='instängd'	feats='Case=Nom|Definite=Ind|Gender=Neut|Number=Sing'	treebank='lines_test'
form='böjt'	lemma='böja'	feats='Case=Nom|Definite=Ind|Degree=Pos|Number=Sing'	treebank='lines_dev'
form='omtyckt'	lemma='omtyckt'	feats='Case=Nom|Definite=Ind|Degree=Pos|Gender=Com|Number=Sing'	treebank='talbanken'
form='knäckt'	lemma='knäcka'	feats='Case=Nom|Definite=Ind|Degree=Pos|Gender=Neut|Number=Sing'	treebank='lines_test'
form='dödsförskräckt'	lemma='dödsförskräckt'	feats='Case=Nom|Definite=Ind|Degree=Pos|Number=Sing'	treebank='lines_dev'
form='utsträckt'	lemma='utsträckt'	feats='Case=Nom|Definite=Ind|Degree=Pos|Number=Sing'	treebank='lines_dev'
form='smörstekt'	lemma='smörstekt'	feats='Case=Nom|Definite=Ind|Degree=Pos|Number=Sing'	treebank='lines_test'
form='kränkt'	lemma='kränka'	feats='Case=Nom|Definite=Ind|Degree=Pos|Gender=Com|Number=Sing'	treebank='lines_test'
form='oinskränkt'	lemma='oinskränkt'	feats='Case=Nom|Definite=Ind|Degree=Pos|Gender=Com|Number=Sing'	treebank='lines_test'
form='misstänkt'	lemma='misstänkt'	feats='Case=Nom|Definite=Ind|Degree=Pos|Gender=Neut|Number=Sing'	treebank='lines_test'
form='dödsmärkt'	lemma='dödsmärkt'	feats='Case=Nom|Definite=Ind|Degree=Pos|Gender=Com|Number=Sing'	treebank='lines_test'
form='Utmärkt'	lemma='utmärkt'	feats='Case=Nom|Definite=Ind|Degree=Pos|Number=Sing'	treebank='lines_test'
form='utmärkt'	lemma='utmärkt'	feats='Case=Nom|Definite=Ind|Degree=Pos|Number=Sing'	treebank='lines_test'
form='utmärkt'	lemma='utmärkt'	feats='Case=Nom|Definite=Ind|Degree=Pos|Number=Sing'	treebank='lines_dev'
form='stärkt'	lemma='stärkt'	feats='Case=Nom|Definite=Ind|Degree=Pos|Gender=Com|Number=Sing'	treebank='lines_test'
form='styvstärkt'	lemma='styvstärkt'	feats='Case=Nom|Definite=Ind|Degree=Pos|Number=Sing'	treebank='lines_dev'
form='utsökt'	lemma='utsöka'	feats='Case=Nom|Definite=Ind|Degree=Pos|Number=Sing'	treebank='lines_dev'
form='betalt'	lemma='betala'	feats='Case=Nom|Degree=Pos|Gender=Neut|Number=Sing'	treebank='lines_test'
form='samfällt'	lemma='samfälld'	feats='Case=Nom|Definite=Ind|Degree=Pos|Gender=Neut|Number=Sing'	treebank='talbanken'
form='oförskämt'	lemma='oförskämd'	feats='Case=Nom|Definite=Ind|Degree=Pos|Gender=Neut|Number=Sing'	treebank='talbanken'
form='förutbestämt'	lemma='förutbestämd'	feats='Case=Nom|Definite=Ind|Degree=Pos|Gender=Neut|Number=Sing'	treebank='lines_test'
form='bekant'	lemma='bekant'	feats='Case=Nom|Definite=Ind|Degree=Pos|Gender=Com|Number=Sing'	treebank='pud'
form='bekant'	lemma='bekant'	feats='Case=Nom|Definite=Ind|Degree=Pos|Gender=Neut|Number=Sing'	treebank='lines_test'
form='bekant'	lemma='bekant'	feats='Case=Nom|Definite=Ind|Gender=Neut|Number=Sing'	treebank='lines_dev'
form='bekant'	lemma='bekant'	feats='Case=Nom|Definite=Ind|Degree=Pos|Gender=Neut|Number=Sing'	treebank='talbanken'
form='bekant'	lemma='bekant'	feats='Case=Nom|Definite=Ind|Degree=Pos|Gender=Neut|Number=Sing'	treebank='lines_dev'
form='välbekant'	lemma='välbekant'	feats='Case=Nom|Definite=Ind|Degree=Pos|Gender=Neut|Number=Sing'	treebank='lines_test'
form='obekant'	lemma='obekant'	feats='Case=Nom|Definite=Ind|Degree=Pos|Gender=Com|Number=Sing'	treebank='talbanken'
form='förment'	lemma='förment'	feats='_'	treebank='talbanken'
form='välkänt'	lemma='välkänd'	feats='Case=Nom|Definite=Ind|Degree=Pos|Gender=Neut|Number=Sing'	treebank='lines_test'
form='okänt'	lemma='okänd'	feats='Case=Nom|Definite=Ind|Degree=Pos|Gender=Neut|Number=Sing'	treebank='pud'
form='förspänt'	lemma='spänna_för'	feats='Case=Nom|Definite=Ind|Degree=Pos|Gender=Neut|Number=Sing'	treebank='talbanken'
form='tänt'	lemma='tänd'	feats='Case=Nom|Definite=Ind|Gender=Neut|Number=Sing'	treebank='lines_test'
form='bevänt'	lemma='bevänt'	feats='Case=Nom|Definite=Ind|Degree=Pos|Gender=Neut|Number=Sing'	treebank='lines_test'
form='insvept'	lemma='insvept'	feats='Case=Nom|Definite=Ind|Gender=Com|Number=Sing'	treebank='lines_test'
form='villkorstyrt'	lemma='villkorsstyrd'	feats='Case=Nom|Definite=Ind|Degree=Pos|Number=Sing'	treebank='lines_dev'
form='tärt'	lemma='tära'	feats='Case=Nom|Definite=Ind|Degree=Pos|Gender=Neut|Number=Sing'	treebank='lines_test'
form='slutfört'	lemma='slutföra'	feats='Case=Nom|Definite=Ind|Degree=Pos|Gender=Neut|Number=Sing'	treebank='lines_test'
form='förtjust'	lemma='förtjust'	feats='Case=Nom|Definite=Ind|Degree=Pos|Number=Sing'	treebank='lines_dev'
form='förtjust'	lemma='förtjust'	feats='Case=Nom|Definite=Ind|Degree=Pos|Gender=Com|Number=Sing'	treebank='lines_test'
form='månbelyst'	lemma='månbelyst'	feats='Case=Nom|Definite=Ind|Degree=Pos|Gender=Com|Number=Sing'	treebank='lines_test'
form='upplyst'	lemma='upplysa'	feats='Case=Nom|Definite=Ind|Degree=Pos|Gender=Com|Number=Sing'	treebank='lines_test'
form='upplyst'	lemma='upplysa'	feats='Case=Nom|Definite=Ind|Degree=Pos|Gender=Neut|Number=Sing'	treebank='lines_test'
form='uppblåst'	lemma='uppblåst'	feats='Case=Nom|Definite=Ind|Degree=Pos|Number=Sing'	treebank='lines_dev'
form='svårlöst'	lemma='svårlöst'	feats='Case=Nom|Definite=Ind|Degree=Pos|Gender=Neut|Number=Sing'	treebank='talbanken'
form='fullsatt'	lemma='fullsatt'	feats='Case=Nom|Definite=Ind|Degree=Pos|Gender=Neut|Number=Sing'	treebank='lines_test'
form='fullsatt'	lemma='fullsatt'	feats='Case=Nom|Definite=Ind|Degree=Pos|Number=Sing'	treebank='lines_dev'
form='tjänstberett'	lemma='tjänstberedd'	feats='Case=Nom|Definite=Ind|Degree=Pos|Gender=Neut|Number=Sing'	treebank='lines_test'
form='omstritt'	lemma='omstridd'	feats='Case=Nom|Definite=Ind|Degree=Pos|Gender=Neut|Number=Sing'	treebank='pud'
form='ingrott'	lemma='ingrott'	feats='Case=Nom|Definite=Ind|Degree=Pos|Gender=Neut|Number=Sing'	treebank='lines_test'
form='berått'	lemma='beråda'	feats='Case=Nom|Degree=Pos'	treebank='talbanken'
form='dött'	lemma='död'	feats='Case=Nom|Definite=Ind|Degree=Pos|Gender=Neut|Number=Sing'	treebank='lines_test'
form='dött'	lemma='död'	feats='Case=Nom|Definite=Ind|Degree=Pos|Number=Sing'	treebank='lines_dev'
form='nött'	lemma='nött'	feats='Case=Nom|Definite=Ind|Degree=Pos|Gender=Com|Number=Sing'	treebank='lines_test'
form='kortväxt'	lemma='kortväxt'	feats='Case=Nom|Definite=Ind|Degree=Pos|Gender=Com|Number=Sing'	treebank='lines_test'
form='planlagda'	lemma='planlägga'	feats='Case=Nom|Definite=Def|Degree=Pos|Number=Plur'	treebank='lines_test'
form='tryckta'	lemma='trycka'	feats='Case=Nom|Definite=Ind|Degree=Pos|Number=Plur'	treebank='lines_test'
form='undertryckta'	lemma='undertrycka'	feats='Case=Nom|Definite=Def|Degree=Pos|Gender=Com|Number=Sing'	treebank='lines_test'
form='uppsträckta'	lemma='uppsträcka'	feats='Case=Nom|Definite=Ind|Degree=Pos|Number=Plur'	treebank='lines_test'
form='torkat'	lemma='torka'	feats='Case=Nom'	treebank='lines_test'
form='dukat'	lemma='duka'	feats='Case=Nom|Definite=Ind|Degree=Pos|Gender=Neut|Number=Sing'	treebank='lines_test'
form='uttalat'	lemma='uttala'	feats='Case=Nom|Definite=Ind|Degree=Pos|Number=Sing'	treebank='lines_dev'
form='förtrollat'	lemma='förtrolla'	feats='Case=Nom|Definite=Ind|Degree=Pos|Gender=Neut|Number=Sing'	treebank='lines_test'
form='utställda'	lemma='utställa'	feats='Case=Nom|Definite=Def|Degree=Pos|Number=Plur'	treebank='lines_test'
form='indämda'	lemma='indämma'	feats='Case=Nom|Definite=Def|Degree=Pos|Gender=Com|Number=Sing'	treebank='lines_test'
form='utplånat'	lemma='utplåna'	feats='Case=Nom|Definite=Ind|Degree=Pos|Gender=Neut|Number=Sing'	treebank='lines_test'
form='skärpta'	lemma='skärpa'	feats='Case=Nom|Definite=Def|Degree=Pos|Gender=Neut|Number=Sing'	treebank='lines_test'
form='installerade'	lemma='installera'	feats='Case=Nom|Definite=Def|Degree=Pos|Number=Sing'	treebank='lines_dev'
form='artikulerade'	lemma='artikulera'	feats='Case=Nom|Definite=Ind|Degree=Pos|Number=Plur'	treebank='lines_dev'
form='formulerade'	lemma='formulera'	feats='Case=Nom|Definite=Ind|Degree=Pos|Number=Plur'	treebank='lines_test'
form='disciplinerade'	lemma='disciplinera'	feats='Case=Nom|Definite=Def|Degree=Pos|Gender=Neut|Number=Sing'	treebank='lines_test'
form='magasinerade'	lemma='magasinera'	feats='Case=Nom|Definite=Def|Degree=Pos|Number=Plur'	treebank='lines_test'
form='grupperade'	lemma='gruppera'	feats='Case=Nom|Definite=Ind|Degree=Pos|Number=Plur'	treebank='lines_test'
form='integrerad'	lemma='integrera'	feats='Case=Nom|Definite=Ind|Degree=Pos|Number=Sing'	treebank='lines_dev'
form='filtrerade'	lemma='filtrera'	feats='Case=Nom|Definite=Ind|Degree=Pos|Gender=Neut|Number=Sing'	treebank='lines_test'
form='Filtrerad'	lemma='filtrera'	feats='Case=Nom|Definite=Ind|Degree=Pos|Gender=Com|Number=Sing'	treebank='lines_test'
form='filtrerat'	lemma='filtrera'	feats='Case=Nom|Definite=Ind|Degree=Pos|Gender=Neut|Number=Sing'	treebank='lines_test'
form='Filtrerat'	lemma='filtrera'	feats='Case=Nom|Definite=Ind|Degree=Pos|Gender=Neut|Number=Sing'	treebank='lines_test'
form='industrialiserade'	lemma='industrialisera'	feats='Case=Nom|Definite=Ind|Degree=Pos|Number=Plur'	treebank='lines_test'
form='stiliserade'	lemma='stilisera'	feats='Case=Nom|Definite=Def|Degree=Pos|Number=Sing'	treebank='lines_dev'
form='improviserat'	lemma='improvisera'	feats='Case=Nom|Definite=Ind|Degree=Pos|Gender=Neut|Number=Sing'	treebank='lines_test'
form='kasserade'	lemma='kassera'	feats='Case=Nom|Definite=Ind|Degree=Pos|Number=Plur'	treebank='lines_test'
form='irriterat'	lemma='irritera'	feats='Case=Nom|Definite=Ind|Degree=Pos|Number=Sing'	treebank='lines_dev'
form='asfalterade'	lemma='asfaltera'	feats='Case=Nom|Definite=Def|Degree=Pos|Number=Plur'	treebank='lines_test'
form='hanterade'	lemma='hantera'	feats='Case=Nom|Definite=Ind|Degree=Pos|Number=Plur'	treebank='lines_dev'
form='dokumenterade'	lemma='dokumentera'	feats='Case=Nom|Definite=Def|Degree=Pos|Gender=Com|Number=Sing'	treebank='lines_test'
form='konverterade'	lemma='konvertera'	feats='Case=Nom|Definite=Def|Degree=Pos|Gender=Com|Number=Sing'	treebank='lines_test'
form='reserverade'	lemma='reservera'	feats='Case=Nom|Definite=Ind|Degree=Pos|Number=Plur'	treebank='lines_test'
form='lagrade'	lemma='lagra'	feats='Case=Nom|Definite=Ind|Degree=Pos|Number=Plur'	treebank='lines_test'
form='förbättrad'	lemma='förbättra'	feats='Case=Nom|Definite=Ind|Degree=Pos|Gender=Com|Number=Sing'	treebank='lines_test'
form='renskurat'	lemma='renskura'	feats='Case=Nom|Definite=Ind|Degree=Pos|Gender=Neut|Number=Sing'	treebank='lines_test'
form='murad'	lemma='mura'	feats='Case=Nom|Definite=Ind|Degree=Pos|Gender=Com|Number=Sing'	treebank='lines_test'
form='kringskuret'	lemma='kringskära'	feats='Case=Nom|Definite=Ind|Degree=Pos|Gender=Neut|Number=Sing'	treebank='lines_test'
form='slutfört'	lemma='slutföra'	feats='Case=Nom|Definite=Ind|Degree=Pos|Gender=Neut|Number=Sing'	treebank='lines_test'
form='visade'	lemma='visa'	feats='Case=Nom'	treebank='lines_dev'
form='anpassat'	lemma='anpassa'	feats='Case=Nom|Definite=Ind|Degree=Pos|Gender=Neut|Number=Sing'	treebank='lines_test'
form='uppassade'	lemma='uppassa'	feats='Case=Nom|Definite=Ind|Degree=Pos|Gender=Com|Number=Plur'	treebank='lines_test'
form='pressad'	lemma='pressa'	feats='Case=Nom|Definite=Ind|Degree=Pos|Number=Sing'	treebank='lines_dev'
form='fernissade'	lemma='fernissa'	feats='Case=Nom|Definite=Ind|Degree=Pos|Number=Plur'	treebank='lines_test'
form='putsade'	lemma='putsa'	feats='Case=Nom|Definite=Ind|Degree=Pos|Number=Plur'	treebank='lines_test'
form='upplysta'	lemma='upplysa'	feats='Case=Nom|Definite=Ind|Degree=Pos|Number=Plur'	treebank='lines_dev'
form='upplyst'	lemma='upplysa'	feats='Case=Nom|Definite=Ind|Degree=Pos|Gender=Neut|Number=Sing'	treebank='lines_test'
form='upplyst'	lemma='upplysa'	feats='Case=Nom|Definite=Ind|Degree=Pos|Gender=Com|Number=Sing'	treebank='lines_test'
form='upplåsta'	lemma='upplåsa'	feats='Case=Nom|Definite=Def|Degree=Pos|Gender=Com|Number=Sing'	treebank='lines_test'
form='lyftade'	lemma='lyfta'	feats='Case=Nom|Definite=Def|Degree=Pos|Number=Plur'	treebank='lines_test'
form='upplyft'	lemma='upplyfta'	feats='Case=Nom|Definite=Ind|Number=Sing'	treebank='lines_dev'
form='avslitet'	lemma='avslita'	feats='Case=Nom|Definite=Ind|Degree=Pos|Gender=Neut|Number=Sing'	treebank='lines_test'
form='rostade'	lemma='rosta'	feats='Case=Nom|Definite=Def|Degree=Pos|Gender=Neut|Number=Sing'	treebank='lines_test'
form='rostade'	lemma='rosta'	feats='Case=Nom|Definite=Ind|Degree=Pos|Number=Plur'	treebank='lines_test'
form='rostade'	lemma='rosta'	feats='Case=Nom|Definite=Def|Degree=Pos|Gender=Com|Number=Sing'	treebank='lines_test'
form='sammanfattade'	lemma='sammanfatta'	feats='Case=Nom|Definite=Ind|Degree=Pos|Number=Plur'	treebank='lines_test'
form='utmattad'	lemma='utmatta'	feats='Case=Nom|Definite=Ind|Gender=Com|Number=Sing'	treebank='lines_dev'
form='upphettat'	lemma='upphetta'	feats='Case=Nom|Definite=Ind|Degree=Pos|Gender=Neut|Number=Sing'	treebank='lines_test'
form='flyttade'	lemma='flytta'	feats='Case=Nom|Definite=Def|Degree=Pos|Number=Sing'	treebank='lines_test'

form='rentvättade'	lemma='rentvätta'	feats='Case=Nom|Definite=Ind|Degree=Pos|Number=Plur'	treebank='lines_test'
form='Oavslutad'	lemma='avsluta'	feats='Case=Nom|Definite=Ind|Degree=Pos|Gender=Com|Number=Sing'	treebank='lines_test'
form='avskruvad'	lemma='avskruva'	feats='Case=Nom|Definite=Ind|Degree=Pos|Gender=Com|Number=Sing'	treebank='lines_test'
form='upphävda'	lemma='upphäva'	feats='Case=Nom|Definite=Def|Degree=Pos|Number=Sing'	treebank='lines_dev'
form='energikrävande'	lemma='energikräva'	feats='Case=Nom|Degree=Pos'	treebank='lines_test'
form='uppsagda'	lemma='uppsagd'	feats='Case=Nom|Definite=Ind|Degree=Pos|Number=Plur'	treebank='talbanken'
form='obebyggda'	lemma='obebyggd'	feats='Case=Nom|Definite=Ind|Degree=Pos|Number=Plur'	treebank='talbanken'
form='nybyggda'	lemma='nybyggd'	feats='Case=Nom|Definite=Ind|Degree=Pos|Number=Plur'	treebank='talbanken'
form='oinvigda'	lemma='oinvigd'	feats='Case=Nom|Definite=Ind|Degree=Pos|Number=Plur'	treebank='talbanken'
form='framåtböjd'	lemma='framåtböjd'	feats='Mood=Ind|VerbForm=Inf|Voice=Pass'	treebank='lines_test'
form='uppåtböjda'	lemma='uppåtböjd'	feats='Case=Nom|Definite=Ind|Degree=Pos|Number=Plur'	treebank='talbanken'
form='upphöjda'	lemma='upphöjd'	feats='Case=Nom|Definite=Def|Degree=Pos|Gender=Neut|Number=Sing'	treebank='lines_test'
form='upphöjda'	lemma='upphöjd'	feats='Case=Nom|Definite=Def|Degree=Pos|Number=Sing'	treebank='lines_test'
form='obetalda'	lemma='obetald'	feats='Case=Nom|Definite=Def|Degree=Pos'	treebank='talbanken'
form='obetalda'	lemma='obetald'	feats='Case=Nom|Definite=Ind|Degree=Pos|Number=Plur'	treebank='lines_test'
form='valda'	lemma='vald'	feats='Case=Nom|Definite=Def'	treebank='lines_dev'
form='skilda'	lemma='skild'	feats='Case=Nom|Definite=Ind|Degree=Pos|Number=Plur'	treebank='lines_test'
form='skilda'	lemma='skild'	feats='Case=Nom|Definite=Ind|Degree=Pos|Number=Plur'	treebank='talbanken'
form='skilda'	lemma='skild'	feats='Case=Nom|Definite=Ind|Degree=Pos|Number=Plur'	treebank='lines_dev'
form='hemskilda'	lemma='hemskild'	feats='Case=Nom|Definite=Ind|Degree=Pos|Number=Plur'	treebank='talbanken'
form='enskilda'	lemma='enskild'	feats='Case=Nom|Definite=Def|Degree=Pos'	treebank='talbanken'
form='enskild'	lemma='enskild'	feats='Case=Nom|Definite=Ind|Degree=Pos|Gender=Com|Number=Sing'	treebank='talbanken'
form='enskilds'	lemma='enskild'	feats='Case=Gen|Definite=Ind|Degree=Pos|Gender=Com|Number=Sing'	treebank='talbanken'
form='enskilda'	lemma='enskild'	feats='Case=Nom|Definite=Def|Degree=Pos|Number=Sing'	treebank='lines_dev'
form='enskilda'	lemma='enskild'	feats='Case=Nom|Definite=Ind|Degree=Pos|Number=Plur'	treebank='lines_test'
form='enskilda'	lemma='enskild'	feats='Case=Nom|Definite=Ind|Degree=Pos|Number=Plur'	treebank='talbanken'
form='enskildes'	lemma='enskild'	feats='Case=Gen|Definite=Def|Degree=Pos|Gender=Masc|Number=Sing'	treebank='talbanken'
form='enskilde'	lemma='enskild'	feats='Case=Nom|Definite=Def|Degree=Pos|Gender=Masc|Number=Sing'	treebank='talbanken'
form='enskilda'	lemma='enskild'	feats='Case=Nom|Definite=Ind|Degree=Pos|Number=Plur'	treebank='lines_dev'
form='enskilde'	lemma='enskild'	feats='Case=Nom|Definite=Def|Degree=Pos|Number=Sing'	treebank='lines_test'
form='enskild'	lemma='enskild'	feats='Case=Nom|Definite=Ind|Degree=Pos|Number=Sing'	treebank='lines_test'
form='enskilt'	lemma='enskild'	feats='Case=Nom|Definite=Ind|Degree=Pos|Gender=Neut|Number=Sing'	treebank='talbanken'
form='frånskildas'	lemma='frånskild'	feats='Case=Gen|Degree=Pos|Number=Plur'	treebank='talbanken'
form='särskilda'	lemma='särskild'	feats='Case=Nom|Definite=Ind|Degree=Pos|Number=Plur'	treebank='talbanken'
form='särskilda'	lemma='särskild'	feats='Case=Nom|Definite=Def|Degree=Pos'	treebank='talbanken'
form='uppfyllda'	lemma='uppfylld'	feats='Case=Nom|Definite=Ind|Degree=Pos|Number=Plur'	treebank='lines_dev'
form='uppfylld'	lemma='uppfylld'	feats='Case=Nom|Definite=Ind|Degree=Pos|Gender=Com|Number=Sing'	treebank='lines_test'
form='luftfyllda'	lemma='luftfylld'	feats='Case=Nom|Definite=Ind|Degree=Pos|Number=Plur'	treebank='talbanken'
form='Smärtfylld'	lemma='smärtfylld'	feats='Case=Nom|Definite=Ind|Degree=Pos|Gender=Com|Number=Sing'	treebank='talbanken'
form='förgyllda'	lemma='förgylld'	feats='Case=Nom|Definite=Def|Degree=Pos|Number=Sing'	treebank='lines_dev'
form='V-ställda'	lemma='V-ställd'	feats='Case=Nom|Definite=Ind|Degree=Pos|Number=Plur'	treebank='lines_test'
form='nollställda'	lemma='nollställd'	feats='Case=Nom|Definite=Def'	treebank='lines_test'
form='lokalanställda'	lemma='lokalanställd'	feats='Case=Nom|Definite=Ind|Degree=Pos|Number=Plur'	treebank='talbanken'
form='tillfredsställda'	lemma='tillfredsställd'	feats='Case=Nom|Definite=Ind|Degree=Pos|Number=Plur'	treebank='talbanken'
form='sålda'	lemma='såld'	feats='Case=Nom|Definite=Ind|Degree=Pos|Number=Plur'	treebank='talbanken'
form='utsålda'	lemma='utsåld'	feats='Case=Nom|Definite=Def|Degree=Pos|Number=Plur'	treebank='lines_test'
form='bestämda'	lemma='bestämd'	feats='Case=Nom|Definite=Ind|Degree=Pos|Number=Plur'	treebank='talbanken'
form='obestämd'	lemma='obestämd'	feats='Case=Nom|Definite=Ind|Degree=Pos|Gender=Com|Number=Sing'	treebank='lines_test'
form='förutbestämt'	lemma='förutbestämd'	feats='Case=Nom|Definite=Ind|Degree=Pos|Gender=Neut|Number=Sing'	treebank='lines_test'
form='bortglömd'	lemma='bortglömd'	feats='Case=Nom|Definite=Ind|Degree=Pos|Gender=Com|Number=Sing'	treebank='lines_test'
form='uppochnervända'	lemma='uppochnervänd'	feats='Case=Nom|Definite=Def|Degree=Pos|Number=Sing'	treebank='lines_test'
form='uppgjorda'	lemma='uppgjord'	feats='Case=Nom|Definite=Ind|Degree=Pos|Number=Plur'	treebank='lines_dev'
form='avgjorda'	lemma='avgjord'	feats='Case=Nom|Definite=Def|Degree=Pos|Gender=Com|Number=Sing'	treebank='lines_dev'
form='datastyrda'	lemma='datastyrd'	feats='Case=Nom|Definite=Ind|Degree=Pos|Number=Plur'	treebank='talbanken'
form='Villkorsstyrd'	lemma='villkorsstyrd'	feats='Case=Nom|Definite=Ind|Degree=Pos|Gender=Com|Number=Sing'	treebank='lines_test'
form='villkorsstyrd'	lemma='villkorsstyrd'	feats='Case=Nom|Definite=Ind|Degree=Pos|Number=Sing'	treebank='lines_dev'
form='Villkorsstyrda'	lemma='villkorsstyrd'	feats='Case=Nom|Definite=Ind|Degree=Pos|Number=Plur'	treebank='lines_dev'
form='villkorsstyrda'	lemma='villkorsstyrd'	feats='Case=Nom|Definite=Ind|Degree=Pos|Number=Plur'	treebank='lines_dev'
form='villkorstyrt'	lemma='villkorsstyrd'	feats='Case=Nom|Definite=Ind|Degree=Pos|Number=Sing'	treebank='lines_dev'
form='beskärda'	lemma='beskärd'	feats='Case=Nom|Definite=Def|Degree=Pos'	treebank='talbanken'
form='iförd'	lemma='iförd'	feats='Case=Nom|Definite=Ind|Gender=Com|Number=Sing'	treebank='lines_test'
form='död'	lemma='död'	feats='Case=Nom|Definite=Ind|Degree=Pos|Gender=Com|Number=Sing'	treebank='pud'
form='döda'	lemma='död'	feats='Case=Nom|Definite=Ind|Degree=Pos|Number=Plur'	treebank='lines_test'
form='döde'	lemma='död'	feats='Case=Nom|Definite=Def|Degree=Pos|Number=Sing'	treebank='lines_test'
form='döda'	lemma='död'	feats='Case=Nom|Degree=Pos|Number=Plur'	treebank='lines_test'
form='dött'	lemma='död'	feats='Case=Nom|Definite=Ind|Degree=Pos|Number=Sing'	treebank='lines_dev'
form='död'	lemma='död'	feats='Case=Nom'	treebank='lines_test'
form='dött'	lemma='död'	feats='Case=Nom|Definite=Ind|Degree=Pos|Gender=Neut|Number=Sing'	treebank='lines_test'
form='Döda'	lemma='död'	feats='Case=Nom|Degree=Pos|Number=Plur'	treebank='lines_test'
form='dödas'	lemma='död'	feats='Case=Gen|Definite=Def|Degree=Pos|Number=Plur'	treebank='lines_test'
form='döda'	lemma='död'	feats='Case=Nom|Definite=Ind|Degree=Pos|Number=Plur'	treebank='talbanken'
form='döda'	lemma='död'	feats='Case=Nom|Degree=Pos|Number=Plur'	treebank='pud'
form='Döda'	lemma='död'	feats='Case=Nom|Degree=Pos|Number=Plur'	treebank='lines_dev'
form='dödas'	lemma='död'	feats='Case=Gen|Definite=Def|Degree=Pos|Number=Plur'	treebank='lines_dev'
form='utdöd'	lemma='utdöd'	feats='Case=Nom|Definite=Ind|Degree=Pos|Gender=Com|Number=Sing'	treebank='talbanken'
form='förenade'	lemma='förenade'	feats='Case=Nom|Definite=Def|Degree=Pos|Number=Sing'	treebank='talbanken'
form='förberedande'	lemma='förberedande'	feats='Case=Nom|Degree=Pos'	treebank='lines_test'
form='gränsöverskridande'	lemma='gränsöverskridande'	feats='Case=Nom|Degree=Pos'	treebank='lines_test'
form='bländande'	lemma='bländande'	feats='Case=Nom|Definite=Ind|Degree=Pos|Gender=Neut|Number=Sing'	treebank='lines_test'
form='bländande'	lemma='bländande'	feats='Degree=Pos'	treebank='lines_test'
form='bländande'	lemma='bländande'	feats='Case=Nom|Degree=Pos'	treebank='lines_test'
form='iakttagande'	lemma='iakttagande'	feats='Case=Nom|Degree=Pos'	treebank='lines_test'
form='eggande'	lemma='eggande'	feats='Case=Nom|Degree=Pos'	treebank='lines_test'
form='Föreliggande'	lemma='föreliggande'	feats='Case=Nom|Definite=Def|Degree=Pos|Number=Sing'	treebank='lines_dev'
form='omkringliggande'	lemma='omkringliggande'	feats='Case=Nom|Degree=Pos'	treebank='lines_test'
form='bakomliggande'	lemma='bakomliggande'	feats='Case=Nom|Degree=Pos'	treebank='lines_test'
form='underliggande'	lemma='underliggande'	feats='Case=Nom|Degree=Pos'	treebank='lines_test'
form='närliggande'	lemma='närliggande'	feats='Case=Nom|Degree=Pos'	treebank='pud'
form='klingande'	lemma='klingande'	feats='Case=Nom|Degree=Pos'	treebank='lines_test'
form='hängande'	lemma='hängande'	feats='Case=Nom|Degree=Pos'	treebank='lines_test'
form='genomträngande'	lemma='genomträngande'	feats='Case=Nom|Degree=Pos'	treebank='lines_test'
form='övergiven'	lemma='överge'	feats='Case=Nom|Definite=Ind|Degree=Pos|Gender=Com|Number=Sing'	treebank='lines_test'
form='övergivna'	lemma='överge'	feats='Case=Nom|Definite=Def|Degree=Pos|Gender=Com|Number=Sing'	treebank='lines_test'
form='leende'	lemma='le'	feats='Case=Nom'	treebank='lines_test'
form='ansedda'	lemma='anse'	feats='Case=Nom|Definite=Def'	treebank='lines_test'
form='förspänt'	lemma='spänna_för'	feats='Case=Nom|Definite=Ind|Degree=Pos|Gender=Neut|Number=Sing'	treebank='talbanken'
form='lyckade'	lemma='lyckas'	feats='Case=Nom|Definite=Def|Degree=Pos|Number=Plur'	treebank='lines_test'
form='gångna'	lemma='gå'	feats='Case=Nom|Definite=Def|Degree=Pos|Gender=Com|Number=Sing'	treebank='lines_test'
form='gångna'	lemma='gå'	feats='Case=Nom|Definite=Def|Degree=Pos|Number=Plur'	treebank='lines_test'
form='förgångnas'	lemma='förgå'	feats='Case=Gen|Definite=Def|Degree=Pos|Number=Sing'	treebank='lines_test'
form='förestående'	lemma='förestå'	feats='Case=Nom|Degree=Pos'	treebank='lines_test'
